5102;900490623;2019-12-31;2019;MILES;7102905;0;7102905;7091459;0;11446;0;7574;523663;0;2727212;140502;2586710;
5103;900490623;2019-12-31;2018;MILES;5211215;0;5211215;4930119;0;281096;0;110928;259285;0;429453;95474;333979;
5104;900220408;2019-12-31;2019;MILES;0;0;0;209942;0;-209942;142095;0;824832;0;162303876;-111017;162414893;
5105;900220408;2019-12-31;2018;MILES;0;0;0;1076150;0;-1076150;0;0;92854;5093;187777929;137608;187640321;
5106;800244105;2019-12-31;2019;MILES;15537743;14092798;1444945;6901218;534260;-5990533;3566090;305897;1449922;9167188;-1592290;1283203;-2875493;
5107;800244105;2019-12-31;2018;MILES;13808503;13726543;81960;6585125;619933;-7123098;4083004;1572801;1689601;4064375;-4480197;284142;-4764339;
5108;890911431;2019-12-31;2019;MILES;237262883;100569379;136693504;13325275;69924358;53443871;9365228;36384646;0;9183214;16877211;27642;16849569;
5109;890911431;2019-12-31;2018;MILES;212246385;141013227;71233158;12816100;45404472;13012586;9861281;5107820;0;14585711;12629196;287683;12341513;
5110;890922586;2019-12-31;2019;MILES;182752072;155819134;26932938;2811846;20135142;3985950;6821162;0;5890782;0;3857622;1398313;2459309;
5111;890922586;2019-12-31;2018;MILES;174018335;148215401;25802934;2724665;19481533;3596736;4013562;96960;2638525;601265;2933035;1258004;1675031;
5112;890401608;2019-12-31;2019;MILES;38683039;28150867;10532172;6281039;1366868;2884265;1886120;293608;0;2055743;2760280;990557;1769723;
5113;890401608;2019-12-31;2018;MILES;42527057;31683306;10843751;5586038;1187838;4069875;1450569;1723287;0;4772832;5291450;2188595;3102855;
5114;900308801;2019-12-31;2019;MILES;7701496;2578766;5122730;3552623;0;1570107;1121133;1027359;475773;0;455829;649763;-193934;
5115;900308801;2019-12-31;2018;MILES;4185305;0;4185305;2287536;0;1897769;1095861;4093268;484618;1892015;-914727;899514;-1814241;
5116;900111607;2019-12-31;2019;MILES;0;0;0;54910;0;-54910;0;453;0;378;-11892999;4013;-11897012;
5117;900111607;2019-12-31;2018;MILES;0;0;0;67509;0;-67509;0;10905;4178;3;-13832083;9386;-13841469;
5118;891401705;2019-12-31;2019;MILES;357024576;286121460;70903116;9872795;20750834;40279487;15027360;4657439;2218976;641094;23454758;6957703;16497055;
5119;891401705;2019-12-31;2018;MILES;318843373;274443758;44399615;9570947;19881801;14946867;16132481;3552862;1770160;1610785;-1357531;-2643718;1286187;
5120;900867653;2019-12-31;2019;MILES;0;0;0;1604631;0;-1604631;276394;0;403237;6;-1477782;-472211;-1005571;
5121;900867653;2019-12-31;2018;MILES;0;0;0;1213981;0;-1213981;180832;412964;146332;7061;-1654384;-231333;-1423051;
5122;830035904;2019-12-31;2019;MILES;39709584;0;39709584;52804802;0;-13095218;2558460;0;1368694;0;-14988301;756871;-15745172;
5123;830035904;2019-12-31;2018;MILES;40628171;0;40628171;40027595;0;600576;2378474;86422;2011251;41224;-128416;675435;-803851;
5124;890925215;2019-12-31;2019;MILES;415444146;316432750;99011396;7333526;15686343;75991527;7753728;38577755;668426;5212928;32936959;14230403;18706556;
5125;890925215;2019-12-31;2018;MILES;362048333;273690962;88357371;6909667;14477870;66969834;9368450;35012206;1035854;4076937;23298691;8936317;14362374;
5126;890904815;2019-12-31;2019;MILES;204595462;187762642;16832820;12099691;3801328;931801;97202;809673;737461;2549868;3312255;5125855;-1813600;
5127;890904815;2019-12-31;2018;MILES;282509798;218510454;63999344;19739466;3854159;40405719;3761972;2753281;565079;4300607;38756152;4669570;34086582;
5128;900017459;2019-12-31;2019;MILES;210233363;0;210233363;574468;0;209658895;3676;1141774;1683550;3799;210200794;923537;209277257;
5129;900017459;2019-12-31;2018;MILES;152369444;0;152369444;1591243;0;150778201;306;0;4257830;231548;155267273;1138459;154128814;
5130;900531210;2019-12-31;2019;MILES;4919937794;1855999921;3063937873;514101172;0;2549836701;0;277567850;24128033;0;5029023266;735256402;4293766864;
5131;900531210;2019-12-31;2018;MILES;4590376735;1877229479;2713147256;324993302;0;2388153954;0;86586134;15014749;0;4441908749;866156062;3575752687;
5132;830068119;2019-12-31;2019;MILES;166846754;110570157;56276597;30122988;12566863;13586746;15219549;627139;169665;811786;3144124;411637;2732487;
5133;830068119;2019-12-31;2018;MILES;163499753;110689398;52810355;31356803;15938124;5515428;14857387;1128463;27682;9380767;2102510;615241;1487269;
5134;800099903;2019-12-31;2019;MILES;186399409;109050775;77348634;19324917;63711013;-5687296;18009218;381302;9130128;2400725;-12501679;-1914458;-10587221;
5135;800099903;2019-12-31;2018;MILES;233898661;141413153;92485508;16412536;66502948;9570024;14256707;783097;8265060;1405185;4560310;2325591;2234719;
5136;890800718;2019-12-31;2019;MILES;780333067;585171773;195161294;42092895;124557681;28510718;25979823;6864095;16358813;47885498;59911111;11802507;48108604;
5137;890800718;2019-12-31;2018;MILES;721821065;523655870;198165195;41067525;128900047;28197623;25511796;5902191;8206586;61136958;66127180;12113174;54014006;
5138;890908901;2019-12-31;2019;MILES;65580702;51539479;14041223;3618590;1173834;9248799;16554889;757152;14441633;486049;7871226;2513678;5357548;
5139;890908901;2019-12-31;2018;MILES;63726481;50308290;13418191;3786859;2141629;7489703;6125537;1024731;5695181;1613862;8265746;2849076;5416670;
5140;860009808;2019-12-31;2019;MILES;705843555;538493191;167350364;31604827;23732623;112012914;19262181;4114970;3219068;3797297;98564857;30043060;68521797;
5141;860009808;2019-12-31;2018;MILES;610435908;470993160;139442748;35470985;22404227;81567536;33866866;4597064;10970147;5127227;62164674;33412847;28751827;
5142;860000006;2019-12-31;2019;MILES;733842985;592337000;141505985;74061787;39868093;27576105;14278754;0;2412153;0;41816350;8933561;32882789;
5143;860000006;2019-12-31;2018;MILES;671478650;541348089;130130561;68529876;32812884;28787801;17519943;0;1799946;0;43281842;10353701;32928141;
5144;900612501;2019-12-31;2019;MILES;515342614;423493107;91849507;18218002;0;73631505;7708070;320871;1143298;3808567;70618453;22763673;47854780;
5145;900612501;2019-12-31;2018;MILES;510379681;408285089;102094592;18435304;0;83659288;8067355;1154537;3567844;3832297;81736734;31456311;50280423;
5146;830113608;2019-12-31;2019;MILES;10330061;17609225;-7279164;23243290;0;-30522454;5457105;4085855;1432653;1949244;-65374937;4718133;-70093070;
5147;830113608;2019-12-31;2018;MILES;5598287;1782828;3815459;27573550;0;-23758091;1862763;5040185;2656350;4445235;-6546440;5499885;-12046325;
5148;800148160;2019-12-31;2019;MILES;0;0;0;1795774;0;-1795774;31672699;6;0;1;776533315;0;776533315;
5149;800148160;2019-12-31;2018;MILES;226467;0;226467;2076642;0;-1850175;4240944;5309937;228999;2;642926157;327;642925830;
5150;900104079;2019-12-31;2019;MILES;91152387;0;91152387;2303466;0;88848921;0;282002;5173274;0;696743706;1623903;695119803;
5151;900104079;2019-12-31;2018;MILES;72921910;0;72921910;2480638;0;70441272;333235;1436984;5472152;0;579160899;6592703;572568196;
5152;900104081;2019-12-31;2019;MILES;69012152;0;69012152;1177661;0;67834491;0;62013;4619377;1;441467598;1112756;440354842;
5153;900104081;2019-12-31;2018;MILES;54583137;0;54583137;1227667;0;53355470;154546;1067759;3850884;0;367868867;3988337;363880530;
5154;901142543;2019-12-31;2019;MILES;0;0;0;165194;0;-165194;0;2544;644180;1;23387669;598139;22789530;
5155;901142543;2019-12-31;2018;MILES;0;0;0;206285;0;-206285;0;55469;415268;2;12682812;-3610142;16292954;
5156;800001204;2019-12-31;2019;MILES;1297051;324298;972753;572866;0;399887;1367686;126144;0;36000;-1057943;87100;-1145043;
5157;800001204;2019-12-31;2018;MILES;1424944;390852;1034092;743756;0;290336;1923589;1459288;0;1402587;-1689954;24055;-1714009;
5158;890300005;2019-12-31;2019;MILES;108476599;38371205;70105394;34946403;971895;34187096;36184234;1505263;2117805;1774236;5061655;272130;4789525;
5159;890300005;2019-12-31;2018;MILES;118533340;38938633;79594707;31580598;1013285;47000824;31061319;10236244;3449131;2039754;17932436;8605354;9327082;
5160;900191693;2019-12-31;2019;MILES;9413301;0;9413301;162064;4531255;4719982;3914167;13;20689;1364;827855;0;-5804958;
5161;900191693;2019-12-31;2018;MILES;8586504;0;8586504;175115;4458321;3953068;4447691;13702;2188;9;-506128;0;1884508;
5162;860004902;2019-12-31;2019;MILES;9914043;337399;9576644;1940890;6987044;648710;265985;22177;91920;1663701;2115480;234976;1880504;
5163;860004902;2019-12-31;2018;MILES;9047137;340852;8706285;1839241;6358299;508745;18124;20649;92686;4463450;5050704;540775;4509929;
5164;830113601;2019-12-31;2019;MILES;252566665;0;252566665;4212600;0;248354065;21404364;31;14153767;0;1040001506;4708198;1035293308;
5165;830113601;2019-12-31;2018;MILES;204116370;0;204116370;3645777;0;200470593;24350257;3864133;13815875;1;888264682;7397498;880867184;
5166;830113603;2019-12-31;2019;MILES;107709278;0;107709278;2906853;0;104802425;14242435;3000033;15858635;1;469009191;6863123;462146068;
5167;830113603;2019-12-31;2018;MILES;89072590;0;89072590;2507653;0;86564937;20864579;2194617;16000005;34;271351564;-22685524;294037088;
5168;830113604;2019-12-31;2019;MILES;714074;0;714074;169510;0;544564;0;2;1405024;5;26422168;412148;26010020;
5169;830113604;2019-12-31;2018;MILES;602768;0;602768;266351;0;336417;26403;115761;1261430;96741;12895851;-2476558;15372409;
5170;860401123;2019-12-31;2019;MILES;0;0;0;13003;0;-13003;0;6874;0;0;-19876;2468;-22344;
5171;860401123;2019-12-31;2018;MILES;0;0;0;102166;0;-102166;0;0;0;1;-102165;7020;-109185;
5172;800148159;2019-12-31;2019;MILES;0;0;0;1556456;0;-1556456;17616279;5;0;5;672436432;0;672436432;
5173;800148159;2019-12-31;2018;MILES;262802;0;262802;1799002;0;-1536200;3558721;4278905;509358;0;566045392;128;566045264;
5174;800148163;2019-12-31;2019;MILES;993321;0;993321;1622224;0;-628903;24046535;225;23557;0;727547319;0;727547319;
5175;800148163;2019-12-31;2018;MILES;962470;0;962470;1902060;0;-939590;4000176;3897043;271208;0;604175410;43622;604131788;
5176;900257179;2019-12-31;2019;MILES;76613583;0;76613583;1246808;0;75366775;0;66;2518727;1;251321616;1211582;250110034;
5177;900257179;2019-12-31;2018;MILES;61332822;0;61332822;1455940;0;59876882;176638;1208031;1676162;1;224783161;3482883;221300278;
5178;900104080;2019-12-31;2019;MILES;72983885;0;72983885;1810515;0;71173370;26271;18842;4894421;191338;534819495;1277324;533542171;
5179;900104080;2019-12-31;2018;MILES;58387108;0;58387108;2050386;0;56336722;265435;1144931;4174778;2;445529069;4819753;440709316;
5180;800027082;2019-12-31;2019;MILES;21386;0;21386;16668;0;4718;0;1;125017;0;169581;41816;127765;
5181;800027082;2019-12-31;2018;MILES;17109;0;17109;60594;0;-43485;0;56;124459;0;127114;100504;26610;
5182;860402513;2019-12-31;2019;MILES;394371;1519572;-1125201;22861;0;-1148062;0;2252;388853;0;-1061830;70558;-1132388;
5183;860402513;2019-12-31;2018;MILES;2845982;1383801;1462181;67117;0;1395064;0;2148;387044;0;1452162;86894;1365268;
5184;890201210;2019-12-31;2019;MILES;101761073;70160288;31600785;0;0;31600785;14313267;25915534;6812217;6156068;-3735800;2520391;-6256191;
5185;890201210;2019-12-31;2018;MILES;116958433;96427225;20531208;0;0;20531208;14553738;27732076;8826354;5824370;-16078238;10242864;-26321102;
5186;830111922;2019-12-31;2019;MILES;316699;237057;79642;29266;0;50376;27342;83;926;26934;2442037;32222;2409815;
5187;830111922;2019-12-31;2018;MILES;197572;127877;69695;63615;0;6080;3005;8066;16470;59834;2670836;48608;2622228;
5188;860003831;2019-12-31;2019;MILES;455592560;270856710;184735850;46586256;134021116;4128478;6056737;4059109;1375913;1624646;-1638533;-1737352;98819;
5189;860003831;2019-12-31;2018;MILES;426175561;255192217;170983344;49607331;117316607;4059406;5756234;6551544;508639;4877657;3503214;-136039;3639253;
5190;860533413;2019-12-31;2019;MILES;421329209;140423164;280906045;30491111;212157024;38257910;31791409;0;331334;3063764;13232838;4753804;7979839;
5191;860533413;2019-12-31;2018;MILES;389331612;132458522;256873090;25697138;221794894;9381058;10620796;26864;280330;1300449;-1378177;912742;-5626673;
5192;900328834;2019-12-31;2019;MILES;69188913;22427076;46761837;1345245;39826212;5590380;3618515;57654;833;1263489;3202364;998549;2203815;
5193;900328834;2019-12-31;2018;MILES;60713175;18915572;41797603;622773;40752843;421987;966960;65558;7187;108732;-494612;-59004;-435608;
5194;900226833;2019-12-31;2019;MILES;9135701;3729588;5406113;388989;3243143;1773981;56469;0;5648;130559;2342558;644543;1698015;
5195;900226833;2019-12-31;2018;MILES;10764128;4766414;5997714;743242;3362295;1892177;144838;0;3880;113237;2945233;632516;2312717;
5196;891304849;2019-12-31;2019;MILES;98616139;79435534;19180605;6092399;5966026;7122180;0;0;0;0;1938344;1103354;834990;
5197;891304849;2019-12-31;2018;MILES;112103077;89646606;22456471;5219243;6570432;10666796;0;7002300;0;2404530;6069026;2996185;3072841;
5198;817002510;2019-12-31;2019;MILES;295871918;247505716;48366202;1284817;23290647;23790738;1943179;1636958;1036192;500394;21747187;3377900;18369287;
5199;817002510;2019-12-31;2018;MILES;295901412;219741021;76160391;1297021;25159878;49703492;1438169;1222838;500723;482955;47878106;7217574;40660532;
5200;900191557;2019-12-31;2019;MILES;0;0;0;212377;0;-212377;334;52880;0;25978;673933;-47368;721301;
5201;900191557;2019-12-31;2018;MILES;0;0;0;199594;0;-199594;205;35548;0;26362;4150273;13250;4137023;
5202;830037774;2019-12-31;2019;MILES;450538328;367976147;82562181;206768;0;82355413;169548;0;0;11251711;100490158;26988662;73501496;
5203;830037774;2019-12-31;2018;MILES;443600693;352408044;91192649;187833;0;91004816;35618;109256;0;5621701;108691014;33297522;75393492;
5204;860001022;2019-12-31;2019;MILES;344108903;198821137;145287766;38340916;116405115;-9458265;13510568;845265;1723921;2365808;-24179413;1469151;-25648564;
5205;860001022;2019-12-31;2018;MILES;337888161;189411234;148476927;42535677;123043454;-17102204;13298273;0;2045294;1620498;-24787313;6274920;-31062233;
5206;890925108;2019-12-31;2019;MILES;322354606;238508091;83846515;8497075;19354787;55994653;2432768;1177758;2079416;4439491;62887314;18341436;44545878;
5207;890925108;2019-12-31;2018;MILES;283275703;214335928;68939775;7227769;17291594;44420412;3579394;1172471;586272;3911049;44181229;12591166;31590063;
5208;830512304;2019-12-31;2019;MILES;48267951;25967122;22300829;5262351;12700022;4338456;0;4737460;0;3769101;3370097;1962957;1407140;
5209;830512304;2019-12-31;2018;MILES;32806589;11184452;21622137;5018539;12038509;4565089;0;1227620;0;259993;3597462;1300251;2297211;
5210;860013704;2019-12-31;2019;MILES;157101299;72546089;84555210;15551418;55461129;13542663;2190871;0;308094;0;11700277;2533880;9166397;
5211;860013704;2019-12-31;2018;MILES;170050893;77864299;92186594;9404529;64882377;17899688;2757234;0;724265;0;12384663;-4351175;16735838;
5212;890930534;2019-12-31;2019;MILES;115778500;95149739;20628761;10346213;10651946;-369398;8365990;1845812;859679;1532067;3009052;-254459;3263511;
5213;890930534;2019-12-31;2018;MILES;118754306;95018766;23735540;10205900;11768458;1761182;6824646;2905392;620029;1732095;1770209;-1088381;2858590;
5214;800244309;2019-12-31;2019;MILES;72203572;51755276;20448296;12354647;9559828;-1466179;3863061;188235;2362310;5046987;1891822;367679;1524143;
5215;800244309;2019-12-31;2018;MILES;68137115;48982856;19154259;12516156;8542344;-1904241;2019139;701468;1620351;4349237;1344740;-161085;1505825;
5216;890906388;2019-12-31;2019;MILES;113739888;99009443;14730445;9098250;0;5632195;8033171;0;62425;2767755;429204;1308413;-879209;
5217;890906388;2019-12-31;2018;MILES;130113529;116163624;13949905;7900990;0;6048915;5684252;0;205817;860950;1431430;592441;838989;
5218;860522602;2019-12-31;2019;MILES;2699711;2128276;571435;254509;289697;27229;1;47254;11341;549852;541167;-43998;585165;
5219;860522602;2019-12-31;2018;MILES;2556734;1950142;606592;374246;372313;-139967;13;190814;14238;1009444;692888;51845;641043;
5220;860031606;2019-12-31;2019;MILES;1388784901;1126238763;262546138;34295602;160275742;67974794;25487315;27598569;788460;38352915;53827828;13345772;40482056;
5221;860031606;2019-12-31;2018;MILES;1065415369;872155311;193260058;30685182;134042644;28532232;24565996;22952633;947294;24230916;6191813;5492125;699688;
5222;811011779;2019-12-31;2019;MILES;600960855;421836532;179124323;71881504;0;107242819;0;0;0;14650059;123987967;38219961;85768006;
5223;811011779;2019-12-31;2018;MILES;548825707;390804622;158021085;49208983;0;108812102;52028076;4179506;875976;50423760;103514717;17403777;86110940;
5224;900090506;2019-12-31;2019;MILES;0;0;0;27918;0;-27918;833;0;0;0;7255175;71370;7183805;
5225;900090506;2019-12-31;2018;MILES;0;0;0;28820;0;-28820;1675;0;0;0;8016510;168879;7847631;
5226;890300466;2019-12-31;2019;MILES;1518141519;951869729;566271790;140624386;367200248;58447156;41574864;55781236;15919451;57487494;192600859;22041876;170558983;
5227;890300466;2019-12-31;2018;MILES;1369712823;858144267;511568556;131158736;374910681;5499139;49344333;23531591;23758976;83314829;182065894;-16845867;198911761;
5228;860036081;2019-12-31;2019;MILES;19858556;49583829;-29725273;56091500;0;-85816773;7311254;16894;165716;197070;-97896061;2228148;-100124209;
5229;860036081;2019-12-31;2018;MILES;80100656;122005830;-41905174;16461485;0;-58366659;5745024;78419;126339;882858;-92283269;3533778;-95817047;
5230;901131258;2019-12-31;2019;MILES;0;0;0;14794;0;-14794;101205;0;0;0;-115999;4038;-120037;
5231;901131258;2019-12-31;2018;MILES;0;0;0;2314;0;-2314;68866;0;0;0;-71180;104;-71284;
5232;802021888;2019-12-31;2019;MILES;148174347;101961097;46213250;13389377;0;32823873;89197218;0;80834124;0;23382335;8725315;14657020;
5233;802021888;2019-12-31;2018;MILES;105572773;56548397;49024376;12586791;0;36437585;87354880;0;75910087;0;32924697;4570125;28354572;
5234;830106920;2019-12-31;2019;MILES;171932824;117895954;54036870;7780079;30278331;15978460;14109509;0;362159;0;2231110;1242927;988183;
5235;830106920;2019-12-31;2018;MILES;164900207;103121149;61779058;6755404;42106433;12917221;7499219;0;5712616;0;11130618;4564730;6565888;
5236;891300513;2019-12-31;2019;MILES;236943227;190759965;46183262;16342474;12990750;16850038;10860436;379578;1127187;2045362;8690106;242538;8447568;
5237;891300513;2019-12-31;2018;MILES;219221319;203116355;16104964;16021828;12087487;-12004351;11738964;342007;1924382;10040657;-12540323;-317644;-12222679;
5238;830122774;2019-12-31;2019;MILES;47322488;38999097;8323391;3245943;3243135;1834313;0;2941897;0;1519374;411790;260000;151790;
5239;830122774;2019-12-31;2018;MILES;43874729;31852427;12022302;3462857;5915524;2643921;0;2871738;0;578272;350455;222740;127715;
5240;860075208;2019-12-31;2019;MILES;105651790;75070667;30581123;4831110;18890644;6859369;955050;437137;183291;120376;6229475;1810550;4418925;
5241;860075208;2019-12-31;2018;MILES;96971847;69262686;27709161;4749421;18292134;4667606;453217;153302;284788;833470;5495771;2264549;3231222;
5242;900525906;2019-12-31;2019;MILES;22645618;263941;22381677;5967902;13616456;2797319;531870;126912;189751;292196;2166983;1104790;1062193;
5243;900525906;2019-12-31;2018;MILES;17693485;311968;17381517;5526835;11036232;818450;357555;220241;50490;614771;346951;345834;1117;
5244;800204226;2019-12-31;2019;MILES;96905171;74356838;22548333;3325870;3527600;15694863;1501455;0;344015;0;17188823;4646355;12542468;
5245;800204226;2019-12-31;2018;MILES;93839444;72023620;21815824;3641851;2669776;15504197;1282568;937195;226377;877672;14388483;4857999;9530484;
5246;830136799;2019-12-31;2019;MILES;2792302297;2604354572;187947725;14226187;34559489;139162049;29506631;14472308;3926989;3374623;104284043;29205560;75078483;
5247;830136799;2019-12-31;2018;MILES;1271848954;1178895036;92953918;8307369;17745728;66900821;12716714;8500284;1359389;1984746;49027958;15602684;33425274;
5248;811036030;2019-12-31;2019;MILES;975728267;658329195;317399072;65434339;139069132;112895601;23284669;0;3614338;0;138359850;33767883;104591967;
5249;811036030;2019-12-31;2018;MILES;894008763;582937115;311071648;57465320;125429707;128176621;16374096;0;3040133;7436530;178559456;32740605;145818851;
5250;860053716;2019-12-31;2019;MILES;19067454;12533910;6533544;2364309;655765;3513470;0;157906;412926;128981;4103566;1334384;2769182;
5251;860053716;2019-12-31;2018;MILES;14814146;10529942;4284204;2829597;505697;948910;0;168810;471214;165018;1719652;984160;735492;
5252;890800127;2019-12-31;2019;MILES;0;0;0;107502;0;-107502;7686;0;57429;2055978;1998219;519048;1479171;
5253;890800127;2019-12-31;2018;MILES;0;0;0;114421;0;-114421;7465;0;56258;46728;-18900;79140;-98040;
5254;800180808;2019-12-31;2019;MILES;160542906;137767562;22775344;9568379;1285062;11921903;4867593;1113596;359721;1453206;7753641;3485240;4268401;
5255;800180808;2019-12-31;2018;MILES;92549393;85899267;6650126;7756236;1087675;-2193785;5428080;4580191;432197;3213069;-8556790;-1265278;-7291512;
5256;860008448;2019-12-31;2019;MILES;459619506;206163967;253455539;32965046;190237086;30253407;26336122;515057;602502;1453168;7144421;-30169022;37313443;
5257;860008448;2019-12-31;2018;MILES;428591749;191801887;236789862;30207799;184489303;22092760;25451004;1176576;56883;0;-3285725;28117709;-31403434;
5258;860017055;2019-12-31;2019;MILES;277395794;191794461;85601333;17874951;34203461;33522921;8490773;0;359252;0;28618219;9533825;19084394;
5259;860017055;2019-12-31;2018;MILES;240156250;163839915;76316335;15942506;30949812;29424017;9124264;0;129851;0;21384330;6399091;14985239;
5260;890903310;2019-12-31;2019;MILES;294448630;239687107;54761523;20846715;19767354;14147454;8037431;1824499;470315;4563692;14629486;2795626;11833860;
5261;890903310;2019-12-31;2018;MILES;305368985;266927480;38441505;23081182;18301622;-2941299;20893975;1452260;13149694;6114977;32774477;-955218;33729695;
5262;890917295;2019-12-31;2019;MILES;163160529;121829459;41331070;8327776;15832570;17170724;3439377;408486;306996;4175403;19335244;5813083;13522161;
5263;890917295;2019-12-31;2018;MILES;146918696;113106205;33812491;7569554;14445005;11797932;1194624;1511878;0;9458212;18458400;4428303;14030097;
5264;901140928;2019-12-31;2019;MILES;0;0;0;48286;3262;-51548;303576;864;377289;3;-10564454;19973;-10584427;
5265;901140928;2019-12-31;2018;MILES;0;0;0;2103;197;-2300;56795;670;70375;0;-2319069;3503;-2322572;
5266;800133063;2019-12-31;2019;MILES;70262853;61141754;9121099;5862425;346930;2911744;5712562;3728601;2904791;1165678;-2675802;-344499;-2331303;
5267;800133063;2019-12-31;2018;MILES;59458727;54421165;5037562;5109085;352972;-424495;6041182;4175129;2766267;1132620;-6741919;-411224;-6330695;
5268;890304130;2019-12-31;2019;MILES;1735783633;1120251348;615532285;138210360;354222856;123099069;64011267;0;474714;4912214;95480396;12826030;70714092;
5269;890304130;2019-12-31;2018;MILES;1685542741;1069702095;615840646;132367455;351120850;132352341;58476305;8083981;476444;0;111356420;13837622;97518798;
5270;811035741;2019-12-31;2019;MILES;116964625;75576051;41388574;22490519;49387750;-30489695;7193289;0;1016007;0;11122724;3235458;7887266;
5271;811035741;2019-12-31;2018;MILES;114786736;68038310;46748426;21147056;48185518;-22584148;6341783;0;1958298;0;25888589;5565671;20322918;
5272;890301960;2019-12-31;2019;MILES;738196336;639721832;98474504;10825698;58283121;29365685;23319617;1157219;1163935;3707690;28366866;7012388;21354478;
5273;890301960;2019-12-31;2018;MILES;702648924;593070287;109578637;16894927;54719872;37963838;24195710;1021664;1178535;1622596;57582902;11509149;46073753;
5274;890322007;2019-12-31;2019;MILES;330867960;242410339;88457621;15907085;23574119;48976417;14882141;47521606;370223;48965527;35908420;16372115;19536305;
5275;890322007;2019-12-31;2018;MILES;332601305;240043259;92558046;14146161;21782522;56629363;17970249;0;224154;9996574;48879842;13634559;35245283;
5276;860075684;2019-12-31;2019;MILES;83201677;54092427;29109250;5620587;7860777;15627886;1868965;6244814;0;162042;7963136;2578524;5384612;
5277;860075684;2019-12-31;2018;MILES;83015840;53168296;29847544;5212408;7773811;16861325;1483326;5512371;0;626659;10243283;3491275;6752008;
5278;900113435;2019-12-31;2019;MILES;109995393;67513760;42481633;12898454;1859884;27723295;930728;683126;1139571;2261431;29510443;8848920;20661523;
5279;900113435;2019-12-31;2018;MILES;65150385;37834818;27315567;10477150;1337674;15500743;1117065;312735;900946;2635621;17607510;6876278;10731232;
5280;900675108;2019-12-31;2019;MILES;9489418;0;9489418;67844;0;9421574;0;0;0;0;9421851;1284;9420567;
5281;900675108;2019-12-31;2018;MILES;13841155;0;13841155;69049;0;13772106;0;0;0;0;13799794;9166;13790628;
5282;860072134;2019-12-31;2019;MILES;1686049642;1003659905;682389737;34078101;0;648311636;35610794;198130456;15282862;0;515109671;162705803;352403868;
5283;860072134;2019-12-31;2018;MILES;1430128312;803660571;626467741;26463498;0;600004243;34687256;307132405;33177305;0;368902697;151779715;217122982;
5284;860004828;2019-12-31;2019;MILES;1424694274;1279723556;144970718;16755629;33358107;94856982;15849250;4914854;3872450;4773164;81750106;26025650;55724456;
5285;860004828;2019-12-31;2018;MILES;1217184603;1128941332;88243271;18466888;28490545;41285838;13076979;6525694;2425230;7069306;30165082;10583433;19581649;
5286;890901271;2019-12-31;2019;MILES;1676554056;1455841208;220712848;24458309;46302849;149951690;23361608;27557928;7650853;28347752;146743314;43807590;102935724;
5287;890901271;2019-12-31;2018;MILES;1700038002;1514131140;185906862;26915808;39590489;119400565;25187964;28105302;7321422;30713004;111735200;34181230;77553970;
5288;890939355;2019-12-31;2019;MILES;1700;0;1700;2133477;0;-2131777;3892;178170;88355;111931;-2131466;69379;-2200845;
5289;890939355;2019-12-31;2018;MILES;40679;0;40679;784872;0;-744193;216358;446560;170676;108824;-1092437;5590;-1098027;
5290;900402331;2019-12-31;2019;MILES;4252331;3213749;1038582;1124513;0;-85931;69982;0;4774;1155753;38749341;793150;37956191;
5291;900402331;2019-12-31;2018;MILES;5456201;4097480;1358721;1827113;0;-468392;85503;323;12825;484075;-1065019;-78408;-986611;
5292;900675423;2019-12-31;2019;MILES;161364184;0;161364184;1068287;0;160295897;57544;6109;1010450;0;161242694;-221332;161464026;
5293;900675423;2019-12-31;2018;MILES;121379931;0;121379931;1019907;0;120360024;2459;360;4586344;0;124943549;1772905;123170644;
5294;900388600;2019-12-31;2019;MILES;444474193;340663757;103810436;12053614;37204837;54551985;5265900;1063718;10499027;3125870;66897652;26613059;40284593;
5295;900388600;2019-12-31;2018;MILES;466742710;383664917;83077793;16710237;32203718;34163838;4633857;2016959;764546;2224534;45022338;17463255;27559083;
5296;890903532;2019-12-31;2019;MILES;879312653;675058276;204254377;56135222;92477887;55641268;35460095;0;1173869;0;30960386;5170383;25790003;
5297;890903532;2019-12-31;2018;MILES;763886897;595657606;168229291;43536072;85906174;38787045;40533257;0;525682;0;16824528;1669529;15154999;
5298;800210501;2019-12-31;2019;MILES;5183988;0;5183988;4036066;0;1147922;395544;1452888;434563;822313;1258390;1017122;241268;
5299;800210501;2019-12-31;2018;MILES;5252925;0;5252925;3021045;0;2231880;370807;172933;435972;30842;3411140;1039223;2371917;
5300;860006333;2019-12-31;2019;MILES;1067600351;921901609;145698742;52113117;90220923;3364702;84382620;19491406;83363211;30688451;13542338;4106038;9436300;
5301;860006333;2019-12-31;2018;MILES;1143714664;1053403660;90311004;57231601;85958539;-52879136;272050143;18859197;227163094;17454131;-99171251;-24407611;-74763640;
5302;890900943;2019-12-31;2019;MILES;6271917312;5237179341;1034737971;195166785;832568575;7002611;79858505;7560222;0;388093815;300828692;97218212;203610480;
5303;890900943;2019-12-31;2018;MILES;5445229922;4528707176;916522746;156579675;740168944;19774127;55901031;6681258;0;328288087;276733140;85891256;190841884;
5304;804010334;2019-12-31;2019;MILES;15464534;5097811;10366723;3175728;6108211;1082784;2411155;0;2608554;0;782506;213219;569287;
5305;804010334;2019-12-31;2018;MILES;14853200;4440925;10412275;5512383;3232193;1667699;2776972;0;3079931;0;1385552;522317;863235;
5306;860049313;2019-12-31;2019;MILES;86177985;68825590;17352395;6983856;13425961;-3057422;7476094;10753245;2435971;14545864;-4304926;-194914;-4110012;
5307;860049313;2019-12-31;2018;MILES;95266956;81279502;13987454;6220332;14244629;-6477507;7823078;7081085;2821559;14266864;-4293247;-1144430;-3148817;
5308;890900121;2019-12-31;2019;MILES;67729986;55496030;12233956;6837275;7520365;-2123684;3975622;498;64363;6625793;2210412;1405623;804789;
5309;890900121;2019-12-31;2018;MILES;74747831;60236615;14511216;6851337;12033611;-4373732;3598000;0;38487;2312272;-3358602;-1587513;-1771089;
5310;815002936;2019-12-31;2019;MILES;187269343;120143183;67126160;3224031;32560749;31341380;6769965;235964;6999370;59011;42476860;11101047;31375813;
5311;815002936;2019-12-31;2018;MILES;192092501;113610022;78482479;1540212;34180930;42761337;5352617;509902;9720411;245660;47112027;16466133;30645894;
5312;900575744;2019-12-31;2019;MILES;0;0;0;95167;0;-95167;120598;0;561;0;3833226;9113;3824113;
5313;900575744;2019-12-31;2018;MILES;0;0;0;456701;0;-456701;12588;438652;2184;192919;138436;129631;8805;
5314;900193739;2019-12-31;2019;MILES;0;0;0;0;0;0;0;591905;0;0;-591905;0;-591905;
5315;900193739;2019-12-31;2018;MILES;0;0;0;0;0;0;0;1011872;0;0;-1011872;80081;-1091953;
5316;830081806;2019-12-31;2019;MILES;8587893;4359334;4228559;1694433;2188870;345256;0;839925;224290;0;-1197520;26372;-1223892;
5317;830081806;2019-12-31;2018;MILES;8466028;4245402;4220626;1720866;2142217;357543;0;1083546;189630;0;-864285;121480;-985765;
5318;860525060;2019-12-31;2019;MILES;652088133;631635390;20452743;12445758;0;8006985;7402057;29440;5313552;1728047;8042646;559624;7483022;
5319;860525060;2019-12-31;2018;MILES;768227792;767059742;1168050;11350171;0;-10182121;10089169;32957;560032;2020681;-17394581;-3672209;-13722372;
5320;900156837;2019-12-31;2019;MILES;0;0;0;0;0;0;0;638871;0;0;-638871;0;-638871;
5321;900156837;2019-12-31;2018;MILES;0;0;0;0;0;0;0;1408295;0;0;-1408295;0;-1468708;
5322;805024510;2019-12-31;2019;MILES;663447;337994;325453;233091;0;92362;1113243;0;382776;0;1024341;-429496;1453837;
5323;805024510;2019-12-31;2018;MILES;127350;0;127350;359201;0;-231851;557572;0;802498;0;2298777;853288;1445489;
5324;805024511;2019-12-31;2019;MILES;2529303;1178038;1351265;1068076;0;283189;2344291;0;2517193;0;5022846;952701;4070145;
5325;805024511;2019-12-31;2018;MILES;1166717;476745;689972;2171475;0;-1481503;1379506;0;1948582;0;3107897;2007694;1100203;
5326;890905047;2019-12-31;2019;MILES;35638827;0;35638827;33609634;0;2029193;1422342;0;610350;54400;1097513;-2030081;3127594;
5327;890905047;2019-12-31;2018;MILES;32806375;0;32806375;30234649;0;2571726;1265806;0;571987;13977051;15895652;2119561;13776091;
5328;800133807;2019-12-31;2019;MILES;256549387;135964832;120584555;2371860;84871076;33341619;9632204;5815405;6926521;727586;25548117;6292899;19255218;
5329;800133807;2019-12-31;2018;MILES;212518095;105588540;106929555;2624104;88324342;15981109;5692911;3824820;488477;0;6951855;2357704;4594151;
5330;860028712;2019-12-31;2019;MILES;18951097;6787541;12163556;2488948;12040;9662568;113278;0;1260106;0;9702560;3928679;5773881;
5331;860028712;2019-12-31;2018;MILES;6518418;6306781;211637;2162350;10010;-1960723;109049;0;1297188;0;693957;577581;116376;
5332;890321151;2019-12-31;2019;MILES;275875617;178029310;97846307;31462920;36220497;30162890;2396640;290293;4081143;10406859;40672020;14485722;26186298;
5333;890321151;2019-12-31;2018;MILES;429911551;275813999;154097552;30462339;65131099;58504114;2352839;186253;3664947;15350694;78296043;30163361;48132682;
5334;900357889;2019-12-31;2019;MILES;679261;92561;586700;1434531;0;-847831;104339;373336;5084;33848;-22451723;25579;-22477302;
5335;900357889;2019-12-31;2018;MILES;207371;58082;149289;1568386;0;-1419097;1622874;130315;7272;39895;-1052285;333010;-1385295;
5336;860037804;2019-12-31;2019;MILES;288841;0;288841;998896;0;-710055;0;421004;222601;39286;9746;-382139;391885;
5337;860037804;2019-12-31;2018;MILES;338526;0;338526;1154293;0;-815767;0;383597;250248;45712;1656077;-512736;2168813;
5338;890930060;2019-12-31;2019;MILES;97057601;71742846;25314755;11046425;6520777;7747553;2678827;363185;814983;2405426;7926676;-292039;8218715;
5339;890930060;2019-12-31;2018;MILES;74118589;62685310;11433279;10842363;4762000;-4171084;2134071;184483;762536;10171370;4444268;2080235;2364033;
5340;890904041;2019-12-31;2019;MILES;18695000;4433000;14262000;10353000;0;3909000;1020000;865000;756000;1661000;4441000;1195000;3246000;
5341;890904041;2019-12-31;2018;MILES;16387000;8518000;7869000;6318000;0;1551000;1094000;2336000;578000;8798000;7497000;1696000;5801000;
5342;890302646;2019-12-31;2019;MILES;54255423;42811617;11443806;13512588;0;-2068782;2966322;3985025;465778;5113314;-2900112;1262825;-4162937;
5343;890302646;2019-12-31;2018;MILES;66482509;58659375;7823134;14807199;0;-6984065;4460073;4431858;1024034;5570862;-9281100;493511;-9774611;
5344;830121796;2019-12-31;2019;MILES;32206771;16734385;15472386;5758710;7723185;1990491;2364961;724281;207373;573718;-319250;-628849;309599;
5345;830121796;2019-12-31;2018;MILES;30539817;16066038;14473779;6678995;8893412;-1098628;2283019;2448755;305709;2583749;-2940944;1123574;-4064518;
5346;890903541;2019-12-31;2019;MILES;28574843;17484525;11090318;3621097;132182;7337039;1750103;0;39603;41;5036880;455104;4581776;
5347;890903541;2019-12-31;2018;MILES;30467610;18542393;11925217;3365562;48200;8511455;1632500;0;26638;68220;6458559;896991;5561568;
5348;830132842;2019-12-31;2019;MILES;0;0;0;1328644;0;-1328644;1051;6;0;141569;-1318582;14157;-1332739;
5349;830132842;2019-12-31;2018;MILES;2;3;-1;1176986;0;-1176987;2067;40682;0;128622;-1275723;40639;-1316362;
5350;900521807;2019-12-31;2019;MILES;90196462;38167638;52028824;43043477;6693596;2291751;1208446;0;0;0;643412;531575;111837;
5351;900521807;2019-12-31;2018;MILES;86219145;35407370;50811775;41827076;6946259;2038440;783197;0;0;0;1328269;439491;888778;
5352;811020107;2019-12-31;2019;MILES;103894544;62246843;41647701;5156158;24141652;12349891;10496004;489506;3996251;1729937;7090569;966780;6123789;
5353;811020107;2019-12-31;2018;MILES;88941760;54993028;33948732;5818734;21450854;6679144;7837908;137178;5767189;666667;5137914;2915139;2222775;
5354;901132307;2019-12-31;2019;MILES;883045;0;883045;1375222;0;-492177;6025777;0;1185908;0;-5332046;-6365332;1033286;
5355;901132307;2019-12-31;2018;MILES;0;792346;-792346;2696675;0;-3489021;65607;0;4522207;0;967579;-799273;1766852;
5356;860517608;2019-12-31;2019;MILES;96711398;82028302;14683096;2821863;8966151;2895082;2567116;514292;112525;530246;428468;409310;19158;
5357;860517608;2019-12-31;2018;MILES;95016398;81112496;13903902;3157994;7985199;2760709;2861976;640649;101000;8323352;7693207;927905;6765302;
5358;860002120;2019-12-31;2019;MILES;1016952251;622533978;394418273;32299891;160051546;202066836;7733378;11501657;668616;1906102;185406519;83651533;101754986;
5359;860002120;2019-12-31;2018;MILES;921466404;630971055;290495349;36271241;142824157;111399951;11740315;4824323;435595;3906059;99176967;51681646;47495321;
5360;800022371;2019-12-31;2019;MILES;109603683;89716331;19887352;4909779;3057504;11920069;6825599;101187;5167211;39871;10852314;3641108;7211206;
5361;800022371;2019-12-31;2018;MILES;108691698;95375335;13316363;4574567;2863125;5878671;6547558;24791;5088240;78054;5428670;2146790;3281880;
5362;890203803;2019-12-31;2019;MILES;28372838;25195504;3177334;5149114;3615660;-5587440;551849;1088249;205023;6932619;473401;449300;24101;
5363;890203803;2019-12-31;2018;MILES;25758756;25585729;173027;4177528;7269807;-11274308;621173;666499;266000;14017905;1762838;911491;851347;
5364;900797309;2019-12-31;2019;MILES;19486802;18065898;1420904;2022646;2192643;-2794385;409826;0;0;0;-3204211;12795;-3217006;
5365;900797309;2019-12-31;2018;MILES;18116081;16424029;1692052;1135860;630047;-73855;262010;0;0;0;-335865;14494;-350359;
5366;890940852;2019-12-31;2019;MILES;16683812;15043735;1640077;2796397;0;-1156320;3699;305557;34305;171257;31938406;4485381;27453025;
5367;890940852;2019-12-31;2018;MILES;16647738;13156992;3490746;1799493;0;1691253;18645;285996;24759;381226;2401912;-583488;2985400;
5368;900243676;2019-12-31;2019;MILES;4433004;0;4433004;17080;0;4415924;614;788;4704;1562292;5981518;536138;5445380;
5369;900243676;2019-12-31;2018;MILES;9999462;0;9999462;51179;0;9948283;699;0;4233;3837011;13788828;1228891;12559937;
5370;900993624;2019-12-31;2019;MILES;67745887;29370886;38375001;6230517;0;32144484;99975;0;0;0;33656947;11195886;22461061;
5371;900993624;2019-12-31;2018;MILES;71334646;45102502;26232144;5624897;0;20607247;587389;0;0;0;20236407;8469536;11766871;
5372;800207462;2019-12-31;2019;MILES;8627203;0;8627203;6119829;0;2507374;1212126;2168531;47924;3188946;2363587;1030582;1333005;
5373;800207462;2019-12-31;2018;MILES;5703810;0;5703810;9783377;0;-4079567;968476;71636;131281;734284;-4254114;622891;-4877005;
5374;860000996;2019-12-31;2019;MILES;882661656;820143173;62518483;26231085;20709648;15577750;9456054;481986;1595457;69032;7339335;2409283;4930052;
5375;860000996;2019-12-31;2018;MILES;800147156;745766630;54380526;24147372;19882450;10350704;4965048;1099799;822328;4898024;10006209;3603195;6403014;
5376;890321924;2019-12-31;2019;MILES;46825916;36382416;10443500;1833043;7340202;1270255;2413940;16506;486518;348870;-3731;-140227;136496;
5377;890321924;2019-12-31;2018;MILES;42170176;30580629;11589547;1742712;6920005;2926830;2930746;24072;0;735397;1038001;176193;861808;
5378;860008355;2019-12-31;2019;MILES;32304690;14774940;17529750;14051431;0;3478319;0;724069;0;325013;10145705;809694;9336011;
5379;860008355;2019-12-31;2018;MILES;22298606;6266588;16032018;14311153;0;1720865;0;316965;0;625685;6244306;882371;5361935;
5380;890321213;2019-12-31;2019;MILES;90801219;71653870;19147349;3113260;7640886;8393203;4809345;0;0;220260;3696048;1060659;2635389;
5381;890321213;2019-12-31;2018;MILES;79557254;62211356;17345898;3042182;6746071;7557645;4721470;0;0;838612;3467722;1114682;2353040;
5382;811032292;2019-12-31;2019;MILES;386209757;270297133;115912624;16659152;4436066;94817406;5611898;3068037;4128695;4221931;98349093;14379462;83969631;
5383;811032292;2019-12-31;2018;MILES;575120287;453379590;121740697;13893208;4374199;103473290;5710161;938033;6433741;7803502;111062339;21142572;89919767;
5384;900108727;2019-12-31;2019;MILES;185250;0;185250;687039;0;-501789;211918;663781;14383;1044311;-821321;-16793;-804528;
5385;900108727;2019-12-31;2018;MILES;330156;0;330156;497568;0;-167412;48872;434529;12264;54539;-582136;624401;-1206537;
5386;900806600;2019-12-31;2019;MILES;1162821485;1056834303;105987182;10345588;115000970;-19359376;15284667;1550086;6995770;6367359;-22831000;-2330829;-20500171;
5387;900806600;2019-12-31;2018;MILES;1014865965;844873791;169992174;8836821;98941097;62214256;91102637;4646491;79237672;6929997;52632797;27733018;24899779;
5388;900863312;2019-12-31;2019;MILES;1194074;0;1194074;1116370;0;77704;0;84753;37826;54798;85575;69127;16448;
5389;900863312;2019-12-31;2018;MILES;6042095;0;6042095;5331505;0;710590;0;2693;104304;136833;949034;318254;630780;
5390;800185008;2019-12-31;2019;MILES;26862467;19644847;7217620;3032203;36410;4149007;0;0;1012379;0;16751039;2031073;14719966;
5391;800185008;2019-12-31;2018;MILES;72474753;50300593;22174160;3363047;29684;18781429;0;0;940794;0;26228570;6980743;19247827;
5392;860002576;2019-12-31;2019;MILES;684324576;581632234;102692342;17545517;88682682;-3535857;126701151;4236850;123160206;13049094;1825286;3650500;-1825214;
5393;860002576;2019-12-31;2018;MILES;546025728;433337625;112688103;17166681;75357139;20164283;82319436;3359237;69209714;8197597;17500672;9578081;7922591;
5394;811000831;2019-12-31;2019;MILES;40140525;28330829;11809696;3010922;8087562;711212;5581375;539351;4980161;1183346;721181;455276;265905;
5395;811000831;2019-12-31;2018;MILES;36456347;26789363;9666984;2925886;6807739;-66641;4189157;133769;3592337;1067988;488405;416057;72348;
5396;800096812;2019-12-31;2019;MILES;85129801;70112774;15017027;3331026;3680068;8005933;3581609;33040;266840;430213;5082244;-3023061;8105305;
5397;800096812;2019-12-31;2018;MILES;87530359;67505487;20024872;3331448;3628834;13064590;2644941;37669;132835;429301;10930419;4127783;6802636;
5398;900877535;2019-12-31;2019;MILES;372587;98788;273799;874621;0;-600822;4357;382045;388483;2118596;53066913;413106;52653807;
5399;900877535;2019-12-31;2018;MILES;1775032;1120130;654902;107759;0;547143;3032;825273;165613;38422252;97989861;188346;97801515;
5400;900560897;2019-12-31;2019;MILES;6765239;0;6765239;107824;0;6657415;7316;22474;1509;13780;1445841;135;1445706;
5401;900560897;2019-12-31;2018;MILES;10946251;0;10946251;429773;0;10516478;3595;18516;10430;42;6512298;12948;6499350;
5402;800042471;2019-12-31;2019;MILES;204579675;174755852;29823823;13216831;15197144;1409848;4473037;210592;165743;1172437;-2274802;265644;-2540446;
5403;800042471;2019-12-31;2018;MILES;199075706;166811976;32263730;12232680;12197123;7833927;2748242;127283;231398;1546797;7434375;2782302;4652073;
5404;860019205;2019-12-31;2019;MILES;169428466;154607437;14821029;2879557;14459914;-2518442;9498112;425259;868532;858044;9626440;1119803;8506637;
5405;860019205;2019-12-31;2018;MILES;152837244;139701377;13135867;1769003;8273661;3093203;4391421;731664;1836011;375952;-2068063;268975;-2337038;
5406;900329769;2019-12-31;2019;MILES;10925948;0;10925948;4351222;0;6574726;2334477;217882;6903;154019;19606783;2222036;17384747;
5407;900329769;2019-12-31;2018;MILES;10131499;0;10131499;3919103;0;6212396;2794044;139870;70592;582492;19932665;1550052;18382613;
5408;900451609;2019-12-31;2019;MILES;0;0;0;9987;0;-9987;0;380;0;0;8494748;1392;8493356;
5409;900451609;2019-12-31;2018;MILES;0;0;0;8761;0;-8761;0;0;0;0;-2345381;1790;-2347171;
5410;830027231;2019-06-30;2019;MILES;70847046;55979187;14867859;758889;3593038;10515932;0;13064;29686;1155;7669593;2477255;5192338;
5411;830027231;2019-06-30;2018;MILES;77992171;61277534;16714637;1975643;5142361;9596633;0;111984;60796;28645;4793048;571296;4221752;
5412;830027231;2019-12-31;2019;MILES;80572155;66736490;13835665;847172;4402224;8586269;0;178598;30637;0;4382013;1021152;3360861;
5413;830027231;2019-12-31;2018;MILES;70847046;55979187;14867859;758889;3593038;10515932;0;13064;29686;1155;7669593;2477255;5192338;
5414;890112132;2019-12-31;2019;MILES;0;0;0;104398;0;-104398;3836964;5305;2899405;24312;24133662;3470287;20663375;
5415;890112132;2019-12-31;2018;MILES;0;0;0;132364;0;-132364;2966678;139727;2967583;0;10091560;1489769;8601791;
5416;860000261;2019-12-31;2019;MILES;513287004;351218076;162068928;31157125;117707896;13203907;15240236;7443349;3337565;1953656;4797610;-3073704;7871314;
5417;860000261;2019-12-31;2018;MILES;474983369;326926904;148056465;34507933;116093929;-2545397;13705179;5307558;2042293;2531644;-2208482;-3980134;1771652;
5418;890802586;2019-12-31;2019;MILES;188824489;169896722;18927767;2992432;7260731;8674604;5041964;903441;0;892845;4036896;1085500;2951396;
5419;890802586;2019-12-31;2018;MILES;171448791;156508127;14940664;3092805;7414833;4433026;4826841;628553;0;746919;674835;206518;468317;
5420;900011545;2019-12-31;2019;MILES;101651585;88229930;13421655;6974322;3149356;3297977;2810761;0;0;0;659380;957898;-298518;
5421;900011545;2019-12-31;2018;MILES;100068526;82998044;17070482;6149933;3283290;7637259;982054;0;0;0;6736358;2407581;4328777;
5422;900197303;2019-12-31;2019;MILES;10992320;10958888;33432;5371557;0;-5338125;220396;64841171;205537;12436;-64640252;-5263204;-59377048;
5423;900197303;2019-12-31;2018;MILES;9343516;11770492;-2426976;4131327;0;-6558303;33256;1903610;48425;45390;-7382011;699440;-8081451;
5424;890311274;2019-12-31;2019;MILES;57530759;41170674;16360085;5993493;9030209;1336383;2127732;116469;107764;1457730;616544;28300;588244;
5425;890311274;2019-12-31;2018;MILES;60840476;48145532;12694944;6146588;8588204;-2039848;1849017;2312035;97020;627054;-5458518;195573;-5654091;
5426;860009008;2019-12-31;2019;MILES;73281916;41185418;32096498;3517090;11857316;16722092;1904510;526334;2265454;0;15761490;6124794;9636696;
5427;860009008;2019-12-31;2018;MILES;74529225;45029310;29499915;3576054;11069024;14854837;2068035;287605;2088796;0;13599971;5747368;7852603;
5428;805012526;2019-12-31;2019;MILES;87344443;0;87344443;6851698;0;80492745;664114;789228;101685;6363;95266032;8818615;86447417;
5429;805012526;2019-12-31;2018;MILES;50538397;0;50538397;5407631;0;45130766;90058;5031128;102102;0;40111682;5859827;34251855;
5430;890921335;2019-12-31;2019;MILES;47514069;31923624;15590445;4734178;8853041;2003226;914779;1619006;26206;1351148;551661;26777;524884;
5431;890921335;2019-12-31;2018;MILES;43674325;27623017;16051308;4660656;9085203;2305449;512794;1709051;40147;1659176;421436;876751;-455315;
5432;890900085;2019-12-31;2019;MILES;132764684;91128641;41636043;13205125;20883079;7547839;2386304;0;246253;2665394;8601743;2034451;6567292;
5433;890900085;2019-12-31;2018;MILES;139260154;92969637;46290517;13411956;21478202;11400359;2509393;0;197174;4764374;14461011;6296727;8164284;
5434;890803003;2019-12-31;2019;MILES;5376073;3402550;1973523;1602741;0;370782;286406;1343651;55374;264659;-600045;8339;-608384;
5435;890803003;2019-12-31;2018;MILES;5168077;1288392;3879685;2213497;0;1666188;410073;1408039;21948;137508;7532;-137849;145381;
5436;890107487;2019-12-31;2019;MILES;6546680512;5577437243;969243269;164063706;576269297;228910266;63750028;87601729;3028780;2023588;170618789;69071386;101547403;
5437;890107487;2019-12-31;2018;MILES;6124024614;5215863336;908161278;154814312;555849885;197497081;57125280;70947877;3378662;3300646;106985081;28649953;78335128;
5438;830057904;2019-12-31;2019;MILES;1919606;0;1919606;3466036;0;-1546430;0;576204;0;1716299;-406335;235320;-641655;
5439;830057904;2019-12-31;2018;MILES;2810007;0;2810007;2603156;0;206851;0;738878;0;9422319;8890292;949556;7940736;
5440;900519515;2019-12-31;2019;MILES;5827740;5652294;175446;154322;0;21124;30350;16888;179001;10529;2448784;-2487607;4936391;
5441;900519515;2019-12-31;2018;MILES;6706507;3825982;2880525;147133;0;2733392;20705;1291;311388;342176;6424343;839108;5585235;
5442;900106251;2019-12-31;2019;MILES;82857658;49061119;33796539;11072986;2907426;19816127;501159;11864742;0;0;6987822;2697809;4290013;
5443;900106251;2019-12-31;2018;MILES;83649026;49036871;34612155;11141823;3144522;20325810;98750;12090261;0;0;6968512;3061087;3907425;
5444;830012157;2019-12-31;2019;MILES;284946624;110101706;174844918;30041901;276951;144526066;1937840;0;0;0;139782273;41796546;97985727;
5445;830012157;2019-12-31;2018;MILES;527023314;211401383;315621931;16826997;117450;298677484;2884090;0;0;0;317656382;99436391;218219991;
5446;811006722;2019-12-31;2019;MILES;49954682;38231359;11723323;2921486;4725960;4075877;2009295;105970;1047349;408697;6926410;1053206;5873204;
5447;811006722;2019-12-31;2018;MILES;37312555;28467934;8844621;2695963;3536340;2612318;2867121;112351;512735;201693;3352708;183010;3169698;
5448;800050714;2019-12-31;2019;MILES;36721721;29855486;6866235;3048248;1482408;2335579;1371479;0;838241;99734;1902075;643871;1258204;
5449;800050714;2019-12-31;2018;MILES;33840259;29099246;4741013;2989436;1555967;195610;1315963;0;821185;138501;-160667;-263445;102778;
5450;830101107;2019-12-31;2019;MILES;36904621;21333234;15571387;9759454;0;5811933;142773;4165575;0;0;58356878;3895169;54461709;
5451;830101107;2019-12-31;2018;MILES;39581827;19453651;20128176;15366441;0;4761735;103086;4620358;0;0;62839314;-2911822;65751136;
5452;900189642;2019-12-31;2019;MILES;141621496;75627384;65994112;29506499;24215305;12272308;0;350498;1010124;16133803;29068799;10110613;18958186;
5453;900189642;2019-12-31;2018;MILES;109732675;49123617;60609058;37424958;15672629;7511471;0;3697950;588912;10823374;15225807;10517149;4708658;
5454;800136505;2019-12-31;2019;MILES;124224879;82134112;42090767;13315452;18280995;10494320;3171191;1168301;0;2849172;9839996;3403647;6436349;
5455;800136505;2019-12-31;2018;MILES;120326380;77003364;43323016;11891138;18603216;12828662;4538311;1486561;0;1798035;8601825;2227560;6374265;
5456;900915705;2019-12-31;2019;MILES;0;0;0;1123;0;-1123;290;0;1564;0;-408458;3273;-411731;
5457;900915705;2019-12-31;2018;MILES;0;0;0;4998;0;-4998;37;0;12782;5725;161392;-5054;166446;
5458;900765896;2019-12-31;2019;MILES;24321376;25450466;-1129090;188079;0;-1317169;48572;177804;35085;1557688;49228;-344523;393751;
5459;900765896;2019-12-31;2018;MILES;27956456;24452011;3504445;161063;0;3343382;7526;479;21496;17715;3374588;1408361;1966227;
5460;800196312;2019-12-31;2019;MILES;17374376;4577738;12796638;7038241;6940233;-1181836;0;0;0;737402;7897566;2707718;5189848;
5461;800196312;2019-12-31;2018;MILES;21482644;5803039;15679605;8192417;9561003;-2073815;0;0;0;845077;1645608;-980408;2626016;
5462;900460297;2019-12-31;2019;MILES;26619349;7547633;19071716;8272543;0;10799173;4981708;1321928;129354;2514399;-14184728;1005782;-15190510;
5463;900460297;2019-12-31;2018;MILES;23491937;6763304;16728633;7460187;0;9268446;7915706;2881912;90974;468518;-898869;-3094487;2195618;
5464;890926766;2019-12-31;2019;MILES;497153870;451659958;45493912;18502436;10163395;16828081;42952433;25243362;41804192;25198733;34569980;5344663;29225317;
5465;890926766;2019-12-31;2018;MILES;508576771;462540822;46035949;24721466;9245343;12069140;42805285;21426011;38931665;21711941;36794565;1390553;35404012;
5466;900252139;2019-12-31;2019;MILES;77071740;3085412;73986328;8923031;0;65063297;15978715;9477769;1226503;88813885;143629962;17671748;125958214;
5467;900252139;2019-12-31;2018;MILES;0;0;0;286271;0;-286271;29245;70975;38958;0;39449590;2524174;36925416;
5468;900875272;2019-12-31;2019;MILES;372587;98788;273799;80157;0;193642;391;87526;2779;689206;52339132;72500;52266632;
5469;900875272;2019-12-31;2018;MILES;1775032;1120130;654902;89550;0;565352;3815;98748;64771;32098517;92309235;188346;92120889;
5470;890900253;2019-12-31;2019;MILES;1484753;0;1484753;54275;0;1430478;57778;28712;0;8996;2269014;458632;1810382;
5471;890900253;2019-12-31;2018;MILES;2054928;0;2054928;45541;0;2009387;0;78561;3742;0;1702329;703373;998956;
5472;901315446;2019-12-31;2019;MILES;0;0;0;43546;0;-43546;0;0;0;0;-830932;0;-830932;
5473;901315446;2019-12-31;2018;MILES;0;0;0;0;0;0;0;0;0;0;0;0;0;ERR valores en cero
5474;800114766;2019-12-31;2019;MILES;171976359;127229262;44747097;7421436;34416882;2908779;2677126;0;0;0;3643641;1378346;2265295;
5475;800114766;2019-12-31;2018;MILES;180281583;134280720;46000863;7095535;32150832;6754496;4110932;0;0;0;5543941;3388291;2155650;
5476;811047212;2019-12-31;2019;MILES;94416747;0;94416747;81310;0;94335437;4388;646588;0;563;93685024;232534;93452490;
5477;811047212;2019-12-31;2018;MILES;98052777;0;98052777;318416;0;97734361;2863;716671;0;588;97015415;49094;96966321;
5478;890205142;2019-12-31;2019;MILES;340566533;263674446;76892087;7714485;60216478;8961124;8365376;1568692;136670;1356919;-441920;943578;-1385498;
5479;890205142;2019-12-31;2018;MILES;301322497;242619698;58702799;7466445;48457994;2778360;3783196;1799736;43064;1165565;-6611963;-1714068;-4897895;
5480;900785905;2019-12-31;2019;MILES;414643802;327916368;86727434;16122009;291347745;-220742320;14318752;0;304120;0;-239532866;-66491309;-173041557;
5481;900785905;2019-12-31;2018;MILES;206268521;154760458;51508063;11954815;158842504;-119289256;2368219;17190503;61370;2225864;-138540416;-29778999;-108761417;
5482;810002455;2019-12-31;2019;MILES;106921293;93825038;13096255;6857344;1450661;4788250;2894580;779235;187965;646663;1949063;643291;1305772;
5483;810002455;2019-12-31;2018;MILES;128905536;114012218;14893318;9159981;995862;4737475;2876206;171060;1085;607494;2298788;526304;1772484;
5484;900131271;2019-12-31;2019;MILES;5923956;0;5923956;15252;0;5908704;8768;56226;0;0;5843710;16803;5826907;
5485;900131271;2019-12-31;2018;MILES;6152090;0;6152090;14936;0;6137154;1696;53094;0;0;6082364;55838;6026526;
5486;900967670;2019-12-31;2019;MILES;0;0;0;142538;0;-142538;24673;82525;388793;0;8063306;468995;7594311;
5487;900967670;2019-12-31;2018;MILES;0;0;0;14853;0;-14853;37453;4;85925;0;3192061;12826;3179235;
5488;900568503;2019-12-31;2019;MILES;479552;475000;4552;41505;0;-36953;0;77378;125678;116440;127787;51479;76308;
5489;900568503;2019-12-31;2018;MILES;312307;0;312307;79530;0;232777;0;376821;128859;23724;8539;0;8539;
5490;901029518;2019-12-31;2019;MILES;0;0;0;2686305;0;-2686305;14776489;0;0;0;5570918;15057;5555861;
5491;901029518;2019-12-31;2018;MILES;0;0;0;2717308;0;-2717308;993255;0;0;0;14636539;62659;14573880;
5492;900866992;2019-12-31;2019;MILES;61607536;6913315;54694221;32981257;1597784;20115180;157787;3887375;185655;256284;16535672;6146465;10389207;
5493;900866992;2019-12-31;2018;MILES;54394157;4955058;49439099;27916450;2306318;19216331;25109;2820011;98895;214544;16644875;6272515;10372360;
5494;802019047;2019-12-31;2019;MILES;35119824;18122117;16997707;3459580;49430;13488697;3173535;0;87498;0;9838694;3010632;6828062;
5495;802019047;2019-12-31;2018;MILES;16544903;1049542;15495361;3461402;1978;12031981;2646730;0;784006;0;6674113;798227;5875886;
5496;830511701;2019-12-31;2019;MILES;1105896;0;1105896;9808;0;1096088;0;1;0;0;1096087;13415;1082672;
5497;830511701;2019-12-31;2018;MILES;2546767;0;2546767;10570;0;2536197;0;0;0;0;2536197;29946;2506251;
5498;860002130;2019-12-31;2019;MILES;1536411000;853859000;682552000;278946000;190786000;212820000;28568000;213000;3291000;21810000;209140000;64541000;144599000;
5499;860002130;2019-12-31;2018;MILES;1490107000;819964000;670143000;276347000;189858000;203938000;27688000;7055000;3116000;21875000;194186000;70876000;123310000;
5500;860002553;2019-12-31;2019;MILES;44205000;38898000;5307000;0;1060000;4247000;945000;1105000;244000;792000;3233000;1239000;1994000;
5501;860002553;2019-12-31;2018;MILES;44923000;38089000;6834000;0;1551000;5283000;1008000;4687000;458000;742000;788000;-42000;830000;
5502;900497538;2019-12-31;2019;MILES;27057298;19020171;8037127;866757;4751381;2418989;400918;0;0;0;830939;815221;15718;
5503;900497538;2019-12-31;2018;MILES;29685515;18898951;10786564;958505;5532219;4295840;764087;0;0;0;217622;3024068;-2806446;
5504;801004314;2019-12-31;2019;MILES;70577400;63577930;6999470;1925047;0;5074423;220369;1619037;0;658141;3893158;2432808;1460350;
5505;801004314;2019-12-31;2018;MILES;57895487;44297104;13598383;0;8735812;4862571;41940;609496;327;174097;4385559;2324244;2061315;
5506;830132938;2019-12-31;2019;MILES;81236645;73254478;7982167;1856935;0;6125232;174378;140017;16787;13311;5840935;2331829;3509106;
5507;830132938;2019-12-31;2018;MILES;21491471;18383471;3108000;1122040;0;1985960;29290;464304;14932;58684;1565982;760058;805924;
5508;800186228;2019-12-31;2019;MILES;220982799;186360547;34622252;19145207;0;15477045;2043600;3886571;40684;1256542;10844100;6480459;4363641;
5509;800186228;2019-12-31;2018;MILES;193678730;155601339;38077391;17862705;0;20214686;2587501;2885954;62904;1245872;16050007;8554507;7495500;
5510;800242482;2019-12-31;2019;MILES;2188975;0;2188975;22478351;0;-20289376;18260042;1030277;1159820;591026;-8141579;197070;-8338649;
5511;800242482;2019-12-31;2018;MILES;2188912;0;2188912;22462173;0;-20273261;28321584;1128336;649021;376584;56592438;982798;55609640;
5512;900443742;2019-12-31;2019;MILES;4459051;0;4459051;13046;0;4446005;16166;31488;9;261;4398621;131135;4267486;
5513;900443742;2019-12-31;2018;MILES;2475884;0;2475884;83347;0;2392537;13549;349921;455666;0;2484733;142396;2342337;
5514;900443757;2019-12-31;2019;MILES;3875643;0;3875643;16463;0;3859180;12845;0;181668;348;4028351;77591;3950760;
5515;900443757;2019-12-31;2018;MILES;2964767;0;2964767;84815;0;2879952;15926;386754;447969;1;2925242;155780;2769462;
5516;800158850;2019-12-31;2019;MILES;99230196;84790019;14440177;3016118;0;11424059;0;7881030;315784;0;5428126;1443847;3984279;
5517;800158850;2019-12-31;2018;MILES;75771533;68237863;7533670;2370685;0;5162985;0;6481934;249745;0;-279249;-294609;15360;
5518;890900120;2019-12-31;2019;MILES;306640295;208373880;98266415;34498637;52338547;11429231;5431302;0;2431342;6630691;16835380;5429614;11405766;
5519;890900120;2019-12-31;2018;MILES;303445414;205781965;97663449;32219155;47803520;17640774;3490160;0;3142327;6395916;24595001;7101723;17493278;
5520;860039444;2019-12-31;2019;MILES;100331979;87439739;12892240;2094735;8061510;2735995;4723971;0;2143686;0;-717984;512795;-1230779;
5521;860039444;2019-12-31;2018;MILES;89841188;77115114;12726074;2569377;7613363;2543334;4308358;41645;2204433;631139;1028903;397801;631102;
5522;800143147;2019-12-31;2019;MILES;7462463;0;7462463;7328000;0;134463;2906867;0;4574168;0;5535389;896301;4639088;
5523;800143147;2019-12-31;2018;MILES;7117567;0;7117567;4135560;0;2982007;1491149;0;2804784;0;6301982;674947;5627035;
5524;900069416;2019-12-31;2019;MILES;4966265;0;4966265;66334;0;4899931;1907;158423;259740;0;4999341;111226;4888115;
5525;900069416;2019-12-31;2018;MILES;1120494;0;1120494;77467;0;1043027;2099;414705;316099;0;942322;23021;919301;
5526;900208445;2019-12-31;2019;MILES;159113861;106016821;53097040;10693593;27340112;15063335;6792454;15829207;201515;13987992;6859937;1313547;5546390;
5527;900208445;2019-12-31;2018;MILES;143235550;93929381;49306169;8296204;23914596;17095369;11966377;21243243;459157;1784653;-13870441;-2585140;-11285301;
5528;900499032;2019-12-31;2019;MILES;291647790;253670664;37977126;4319528;22605925;11051673;10830740;429842;605815;1435377;1832283;-687756;2520039;
5529;900499032;2019-12-31;2018;MILES;245876812;212439598;33437214;4595668;24121516;4720030;8932073;979037;344797;1018186;-3828097;864894;-4692991;
5530;900153185;2019-12-31;2019;MILES;25411286;0;25411286;116753;0;25294533;0;0;1457;0;25295990;40619;25255371;
5531;900153185;2019-12-31;2018;MILES;28156755;0;28156755;216446;0;27940309;0;0;2238;0;27942547;2497;27940050;
5532;901147970;2019-12-31;2019;MILES;96447994;0;96447994;51118;0;96396876;493;1334213;9501;0;95071671;187132;94884539;
5533;901147970;2019-12-31;2018;MILES;100064720;0;100064720;94499;0;99970221;624;1191;22273;0;99990679;0;99990679;
5534;800042175;2019-12-31;2019;MILES;110491783;87527853;22963930;2226363;7477728;13259839;9014023;37213;6620141;1465835;13146039;4735038;8411001;
5535;800042175;2019-12-31;2018;MILES;103736478;85939226;17797252;2103697;7098884;8594671;7263778;10745;2763887;1257164;6155856;1947487;4208369;
5536;900197910;2019-12-31;2019;MILES;20784617;13278180;7506437;3232591;901330;3372516;999805;643363;8176;205141;2021656;1736994;284662;
5537;900197910;2019-12-31;2018;MILES;17890249;11934035;5956214;2195256;1023384;2737574;711025;61747;56706;178975;2200483;611285;1589198;
5538;800172954;2019-12-31;2019;MILES;0;0;0;1573540;0;-1573540;4502425;1449832;7055937;1908193;82676404;-270226;82946630;
5539;800172954;2019-12-31;2018;MILES;0;0;0;1518648;0;-1518648;5128364;588451;7864525;1209818;64970575;1187088;63783487;
5540;860528319;2019-12-31;2019;MILES;60250613;42777008;17473605;946934;1902684;14623987;1143778;4563778;164764;1002753;29829852;3033650;26796202;
5541;860528319;2019-12-31;2018;MILES;36231481;26976412;9255069;1083613;1708788;6462668;117527;6809544;196297;224253;24226058;427942;23798116;
5542;900569531;2019-12-31;2019;MILES;67932093;59869867;8062226;0;9098981;-1036755;521327;503921;21140;1186196;795537;207020;588517;
5543;900569531;2019-12-31;2018;MILES;60448054;52696775;7751279;0;8778370;-1027091;249733;399921;18198;1844209;1378820;-53617;1432437;
5544;860535628;2019-12-31;2019;MILES;7189294;6146124;1043170;153921;942781;-53532;597234;5460;527840;194325;138456;24590;113866;
5545;860535628;2019-12-31;2018;MILES;8447764;7130552;1317212;121701;1269872;-74361;267352;0;255589;228608;172918;81399;91519;
5546;860032436;2019-12-31;2019;MILES;32811225;27271389;5539836;2469718;619324;2450794;3979065;0;435845;3341095;2285955;994109;1291846;
5547;860032436;2019-12-31;2018;MILES;29160223;24928383;4231840;2362056;650528;1219256;1047857;0;636049;371279;1178727;366798;811929;
5548;830000324;2019-12-31;2019;MILES;46105851;28633202;17472649;9560253;0;7912396;0;13918815;0;4685647;-1320772;2576077;-3896849;
5549;830000324;2019-12-31;2018;MILES;118247501;101410398;16837103;10532591;0;6304512;0;3855884;0;3682555;6131183;2566821;3564362;
5550;805006014;2019-12-31;2019;MILES;1071280596;556012976;515267620;394130247;94466423;26670950;0;20097557;0;0;48659159;785880;47873279;
5551;805006014;2019-12-31;2018;MILES;1069240464;567333844;501906620;414735087;104315754;-17144221;0;15119492;0;0;2902899;6181806;-3278907;
5552;830511290;2019-12-31;2019;MILES;46952844;0;46952844;218162;30507165;16227517;2448981;35947;14654;276786;14034029;812390;13221639;
5553;830511290;2019-12-31;2018;MILES;45954146;0;45954146;254350;31715802;13983994;6172946;182062;84918;551065;8264969;3190750;5074219;
5554;860002536;2019-12-31;2019;MILES;1078564070;694563991;384000079;129612194;229047907;25339978;37368234;0;10339836;17649872;-22166822;10092902;-32259724;
5555;860002536;2019-12-31;2018;MILES;1071929603;686492957;385436646;192877691;226863464;-34304509;38541564;0;19344519;18058529;-58517527;-9405351;-49112176;
5556;800058607;2019-12-31;2019;MILES;334493628;288460809;46032819;12252417;24280632;9499770;5723745;127192;5690196;723983;10063012;3486806;6576206;
5557;800058607;2019-12-31;2018;MILES;241296548;207303136;33993412;10808902;19970976;3213534;3955938;188381;2556241;793632;2419088;1402803;1016285;
5558;890200877;2019-12-31;2019;MILES;6271994;4190678;2081316;8184128;10562789;-16665601;6304791;6369092;114437;2771305;-26637737;-140586;-26497151;
5559;890200877;2019-12-31;2018;MILES;126703608;113019856;13683752;9318808;2717032;1647912;15780119;4374582;1059016;4339791;-9990315;-6124725;-3865590;
5560;901062828;2019-12-31;2019;MILES;0;0;0;65052;0;-65052;0;215;0;0;2567852;5419;2562433;
5561;901062828;2019-12-31;2018;MILES;0;0;0;57191;0;-57191;0;422;0;0;12852019;12746;12839273;
5562;891300199;2019-12-31;2019;MILES;2982;0;2982;172601;27864;-197483;706;16271;0;169523;-39201;-2073;-37128;
5563;891300199;2019-12-31;2018;MILES;457698;550449;-92751;147075;0;-239826;2537;778;1046;772;-226383;-66311;-160072;
5564;800059608;2019-12-31;2019;MILES;47570140;26855559;20714581;2997678;16257198;1459705;769333;166962;421869;1243285;2291074;592955;1698119;
5565;800059608;2019-12-31;2018;MILES;40976262;21707323;19268939;3132613;15539373;596953;507029;765251;285181;1577715;1187569;-57215;1244784;
5566;901059574;2019-12-31;2019;MILES;0;0;0;77564;0;-77564;5274834;1248555;99634;0;-5220103;0;-5220103;
5567;901059574;2019-12-31;2018;MILES;0;0;0;71115;0;-71115;3387421;3022758;600031;0;538373;0;538373;
5568;801004661;2019-12-31;2019;MILES;3001155;815979;2185176;236959;1560657;387560;2837;17581;106099;330306;1760479;265660;1494819;
5569;801004661;2019-12-31;2018;MILES;3110269;829678;2280591;221589;1155553;903449;9333;21344;96881;191734;1872808;71695;1801113;
5570;800064391;2019-12-31;2019;MILES;45810313;39625236;6185077;4397699;3150422;-1363044;149687;28669;642053;596408;-5732203;517928;-6250131;
5571;800064391;2019-12-31;2018;MILES;44381814;36594886;7786928;4518801;1528349;1739778;395217;29018;678359;1471010;3561724;1991290;1570434;
5572;800229393;2019-12-31;2019;MILES;73010041;57634453;15375588;0;0;15375588;11357705;22463866;61714;3863733;-16532513;2513584;-19046097;
5573;800229393;2019-12-31;2018;MILES;107869649;83074454;24795195;0;0;24795195;17317616;25961797;388995;4482215;-24514339;-4957868;-19556471;
5574;890110147;2019-12-31;2019;MILES;83386118;59255561;24130557;9027904;4079549;11023104;3950598;563925;233873;242573;7257406;4896631;2360775;
5575;890110147;2019-12-31;2018;MILES;71616174;44100339;27515835;9118903;4552176;13844756;1788298;420676;294958;560103;13095714;5813196;7282518;
5576;890902266;2019-12-31;2019;MILES;20562914;12372236;8190678;5316118;0;2874560;640906;127989;90945;155919;2255581;915204;1340377;
5577;890902266;2019-12-31;2018;MILES;21984534;13367124;8617410;5894750;0;2722660;551624;252672;40128;253729;1898828;1047095;851733;
5578;890300431;2019-12-31;2019;MILES;702639525;632475944;70163581;26458597;33596050;10108934;53499599;4328491;30085749;7247217;-7989317;1519155;-9508472;
5579;890300431;2019-12-31;2018;MILES;738980409;682445444;56534965;25139865;29737298;1657802;56263281;1901713;33073914;5671659;-16430389;-3216384;-13214005;
5580;811004805;2019-12-31;2019;MILES;3404239;2847426;556813;3295706;630695;-3369588;4026088;2369769;313777;2580770;-273230;-1701429;1428199;
5581;811004805;2019-12-31;2018;MILES;14989926;15833197;-843271;5366935;3676418;-9886624;4540862;3392754;1204926;2059707;-9234125;-7696583;-1537542;
5582;890904615;2019-12-31;2019;MILES;75512981;52013043;23499938;4420809;14531937;4547192;2245260;213771;49325;4024807;6162293;1564847;4597446;
5583;890904615;2019-12-31;2018;MILES;52144499;31469497;20675002;5836709;12450548;2387745;1953544;124707;178352;3063863;3551709;1499967;2051742;
5584;890704021;2019-12-31;2019;MILES;49128428;43946444;5181984;11186881;0;-6004897;5303935;505572;154206;16565552;5614426;1260323;4354103;
5585;890704021;2019-12-31;2018;MILES;38849753;39004286;-154533;10213904;0;-10368437;5029957;486317;91016;17850959;2204420;-858340;3062760;
5586;900444197;2019-12-31;2019;MILES;4225600;0;4225600;15176;0;4210424;3871;31488;140195;261;4315521;33815;4281706;
5587;900444197;2019-12-31;2018;MILES;2482381;0;2482381;51524;0;2430857;3813;0;163627;0;2590671;66105;2524566;
5588;900066708;2019-12-31;2019;MILES;7300229;0;7300229;4924909;0;2375320;5193456;73192;0;13788875;35499802;1826597;33673205;
5589;900066708;2019-12-31;2018;MILES;5907342;0;5907342;4421504;0;1485838;3376701;337781;0;5812223;15688243;549059;15139184;
5590;891300241;2019-12-31;2019;MILES;631073423;472331545;158741878;28381549;48169115;82191214;44721986;7120328;2681345;20631014;53690356;16857842;36832514;
5591;891300241;2019-12-31;2018;MILES;554487320;441600455;112886865;29186759;43693887;40006219;33154322;14555591;3969525;26737370;22162099;-3704783;25866882;
5592;800114341;2019-12-31;2019;MILES;2943511;0;2943511;398313;0;2545198;4074;10;181839;0;5232126;42133;5189993;
5593;800114341;2019-12-31;2018;MILES;0;0;0;446780;0;-446780;40347;343;151121;0;27976138;87170;27888968;
5594;890903858;2019-12-31;2019;MILES;2543318839;1756210098;787108741;138553841;791558983;-143004083;27079300;0;0;3524356;-165636515;2215602;-167852117;
5595;890903858;2019-12-31;2018;MILES;1485823726;1018925332;466898394;54423870;558377863;-145903339;52042498;0;0;93785418;-104100631;3583732;-107684363;
5596;900626067;2019-12-31;2019;MILES;1089503;1005790;83713;321437;0;-237724;0;3927;67322;239911;65582;0;65582;
5597;900626067;2019-12-31;2018;MILES;142885;120868;22017;206299;0;-184282;0;13432;100702;100829;3817;0;3817;
5598;890900291;2019-12-31;2019;MILES;1537549392;1351225497;186323895;50560197;67555080;68208618;23407923;7524141;1595732;5091462;43829065;16132648;27696417;
5599;890900291;2019-12-31;2018;MILES;1402107663;1236396590;165711073;46106896;68857186;50746991;24775196;9035898;1758572;6881728;23077873;8612423;14465450;
5600;860025639;2019-12-31;2019;MILES;205384075;150607354;54776721;17556043;10163353;27057325;15724167;965426;15147986;1864045;26971800;9418451;17553349;
5601;860025639;2019-12-31;2018;MILES;186724329;130852136;55872193;17127300;11677582;27067311;14075061;1046086;13785537;2226209;29387982;10608649;18779333;
5602;860000656;2019-12-31;2019;MILES;201153597;152990509;48163088;34948701;0;13214387;15155201;1184685;11544453;4985872;5449841;-72130;5521971;
5603;860000656;2019-12-31;2018;MILES;170458715;132711029;37747686;32104202;0;5643484;9543966;807745;5468177;2171572;6150574;2076872;4073702;
5604;830001114;2019-12-31;2019;MILES;79526618;48552668;30973950;10279366;4972552;15722032;1839160;357613;2094073;498246;16117578;3256418;12861160;
5605;830001114;2019-12-31;2018;MILES;63554511;39088848;24465663;8563115;3348556;12553992;914703;169343;1635522;557236;13662704;2751990;10910714;
5606;830026818;2019-12-31;2019;MILES;94590261;75180511;19409750;4306740;8431654;6671356;1282964;66936;289948;298113;5909517;2028681;3880836;
5607;830026818;2019-12-31;2018;MILES;82008263;65611939;16396324;3726062;7411348;5258914;979588;238619;205523;175772;4427644;1863443;2564201;
5608;900330490;2019-12-31;2019;MILES;0;0;0;689230;0;-689230;4888405;0;0;0;-3143759;19082;-3162841;
5609;900330490;2019-12-31;2018;MILES;0;0;0;30074;0;-30074;1852244;6294411;0;0;-8184634;5627;-8190261;
5610;805024036;2019-12-31;2019;MILES;0;0;0;186796;0;-186796;69964;0;301104;0;1689698;84172;1605526;
5611;805024036;2019-12-31;2018;MILES;0;0;0;155890;0;-155890;50355;0;196467;0;2326589;292625;2033964;
5612;805023973;2019-12-31;2019;MILES;47089;0;47089;121426;0;-74337;58329;0;42021;0;1285656;-53731;1339387;
5613;805023973;2019-12-31;2018;MILES;45323;0;45323;198277;0;-152954;34631;0;4458;0;1217826;122804;1095022;
5614;805023974;2019-12-31;2019;MILES;14954;0;14954;323069;0;-308115;57410;0;96165;0;1158432;48076;1110356;
5615;805023974;2019-12-31;2018;MILES;14207;0;14207;484353;0;-470146;54738;0;6535;0;1388202;223382;1164820;
5616;805024093;2019-12-31;2019;MILES;0;0;0;84470;0;-84470;77314;0;36589;0;1258954;68148;1190806;
5617;805024093;2019-12-31;2018;MILES;0;0;0;86132;0;-86132;32925;0;4459;0;1602444;221284;1381160;
5618;805023971;2019-12-31;2019;MILES;207000;145195;61805;139024;0;-77219;149592;0;194316;0;1809596;50213;1759383;
5619;805023971;2019-12-31;2018;MILES;0;0;0;201380;0;-201380;74317;0;131130;124605;2552288;197748;2354540;
5620;800078108;2019-12-31;2019;MILES;70866823;40228895;30637928;19197805;6163969;5276154;7342435;0;4682973;0;2616692;1118017;1498675;
5621;800078108;2019-12-31;2018;MILES;61823380;33052767;28770613;17651498;5819129;5299986;7664187;0;4839484;0;2475283;1006814;1468469;
5622;900401714;2019-12-31;2019;MILES;55512085;33141871;22370214;5459874;8154359;8755981;2756488;1415969;1967882;1451606;8620722;2095511;6525211;
5623;900401714;2019-12-31;2018;MILES;53353947;31107523;22246424;6575722;8426315;7244387;5816434;849536;4173897;2417263;7442790;2678233;4764557;
5624;891000324;2019-12-31;2019;MILES;459263462;225168045;234095417;14629153;180207570;39258694;1066782;0;33293;436528;42586048;28864762;13721286;
5625;891000324;2019-12-31;2018;MILES;411789420;204920181;206869239;15976112;153157457;37735670;971516;0;23679;456960;34672252;12848845;21823407;
5626;830132841;2019-12-31;2019;MILES;0;94880;-94880;7709160;0;-7804040;4955;26893;50;26381;52544947;188091;52356856;
5627;830132841;2019-12-31;2018;MILES;9585904;4755898;4830006;1242980;0;3587026;23736;8035;607;0;58812131;970269;57841862;
5628;860054886;2019-12-31;2019;MILES;110479745;81272621;29207124;7175834;11480594;10550696;1353637;804285;167110;342356;12471054;3062392;9408662;
5629;860054886;2019-12-31;2018;MILES;115175488;83115244;32060244;8838421;12130096;11091727;1291558;1195081;177847;678184;12262366;4899705;7362661;
5630;860027710;2019-12-31;2019;MILES;28852286;0;28852286;775988;0;28076298;48563;221;0;13;587285;171564;415721;
5631;860027710;2019-12-31;2018;MILES;28343748;0;28343748;861445;0;27482303;15152;0;0;0;-26670988;689445;-27360433;
5632;860022309;2019-12-31;2019;MILES;87569780;0;87569780;1890284;0;85679496;131751;8380000;0;1214;33825020;432078;33392942;
5633;860022309;2019-12-31;2018;MILES;81512252;0;81512252;2264503;0;79247749;86461;77;0;0;14743295;209550;14533745;
5634;890931654;2019-12-31;2019;MILES;84653657;87438184;-2784527;3714502;2017826;-8516855;932395;2712528;7671;1211767;-10954711;-2851557;-8103154;
5635;890931654;2019-12-31;2018;MILES;83557351;71735883;11821468;3623197;1425975;6772296;697995;902876;24646;1103964;6501873;-22123041;28624914;
5636;860059851;2019-12-31;2019;MILES;59011919;44762398;14249521;8029605;2080035;4139881;2104852;294659;1179529;555343;4726767;1284229;3442538;
5637;860059851;2019-12-31;2018;MILES;48181221;31597926;16583295;12058762;1877809;2646724;840994;552274;469382;542289;3254631;976573;2278058;
5638;832000402;2019-12-31;2019;MILES;112454075;103888040;8566035;7275397;1098550;192088;3039615;96393;1951028;41823;129950;-240438;370388;
5639;832000402;2019-12-31;2018;MILES;109436525;103648373;5788152;7334712;1291157;-2837717;1156633;181547;1350506;720270;1576658;602982;973676;
5640;890900281;2019-12-31;2019;MILES;820166787;596848155;223318632;34275864;124537515;64505253;21354994;5669236;206871;3056092;38428893;13142640;25286253;
5641;890900281;2019-12-31;2018;MILES;701781652;509235273;192546379;30949854;109329144;52267381;22172757;5164555;661515;2583651;26958427;11752145;15206282;
5642;890304403;2019-12-31;2019;MILES;14690943;0;14690943;13574200;0;1116743;14597;97049;204582;14763;19602649;351411;19251238;
5643;890304403;2019-12-31;2018;MILES;13195113;0;13195113;12663611;0;531502;127122;160122;533743;10865;13563775;578510;12985265;
5644;800144947;2019-12-31;2019;MILES;2927210;4452683;-1525473;191530;0;-1717003;24445;293218;0;29381;-2051766;-487000;-1564766;
5645;800144947;2019-12-31;2018;MILES;4135350;4089302;46048;318973;3037;-275962;4203;1342;0;3966;-351572;-114480;-237092;
5646;890903024;2019-12-31;2019;MILES;362008803;270608389;91400414;10089296;66728512;14582606;15912397;298434;7073831;11428391;17861811;675703;17186108;
5647;890903024;2019-12-31;2018;MILES;327791061;243399852;84391209;10762562;59715982;13912665;29241935;795155;16978067;5775094;4745071;1692295;3052776;
5648;860052634;2019-12-31;2019;MILES;297925241;260577860;37347381;12715114;35727633;-11095366;13300481;1365819;1279549;17582464;-6899653;-1594693;-5304960;
5649;860052634;2019-12-31;2018;MILES;262473818;229587739;32886079;11809730;38797533;-17721184;11771059;3572629;1650463;18014066;-13400343;-185000;-13215343;
5650;811014994;2019-12-31;2019;MILES;866846682;546499341;320347341;60648393;144681721;115017227;38709500;0;1167746;0;132166886;26037754;106129132;
5651;811014994;2019-12-31;2018;MILES;784903341;494194664;290708677;55687617;130593859;104427201;40944120;0;798117;0;127845786;8346873;119498913;
5652;860024714;2019-12-31;2019;MILES;40184204;0;40184204;341490;0;39842714;77049;11;0;22100;17298250;275172;17023078;
5653;860024714;2019-12-31;2018;MILES;36722626;0;36722626;476843;0;36245783;144265;0;0;4800;-11873335;375872;-12249207;
5654;805024119;2019-12-31;2019;MILES;9804128;7164089;2640039;1288007;363332;988700;275586;1252861;0;1481819;942072;402253;539819;
5655;805024119;2019-12-31;2018;MILES;9411758;5968674;3443084;1314103;284783;1844198;323197;1423186;0;1287687;1385502;655136;730366;
5656;800157723;2019-12-31;2019;MILES;304086;0;304086;256001;0;48085;62209;125372;12527;189809;15850017;67996;15782021;
5657;800157723;2019-12-31;2018;MILES;944387;0;944387;328698;0;615689;77261;11608;22975;17771;10546157;56429;10489728;
5658;900129597;2019-12-31;2019;MILES;23496970;12566041;10930929;32625408;44217478;-65911957;27712318;41932263;16461094;9336;-119086108;-3774850;-115311258;
5659;900129597;2019-12-31;2018;MILES;28521805;6319911;22201894;11642157;58376418;-47816681;32319654;2742798;23601326;5668988;-53608819;2590301;-56199120;
5660;860528871;2019-12-31;2019;MILES;21699625;12673466;9026159;2391460;507115;6127584;1047023;197118;633823;90137;5607403;2408347;3199056;
5661;860528871;2019-12-31;2018;MILES;14442499;7652370;6790129;2140302;828218;3821609;74178;162264;165241;89134;3839542;1326482;2513060;
5662;800165605;2019-12-31;2019;MILES;1167021;0;1167021;217156;0;949865;304051;33776;16;4;703908;92409;611499;
5663;800165605;2019-12-31;2018;MILES;482634;0;482634;175115;0;307519;298880;10233;32;852;603930;150527;453403;
5664;890402766;2019-12-31;2019;MILES;40034634;24989456;15045178;5459376;65935;9519867;1669039;49633;213203;85478;9716374;1774260;7942114;
5665;890402766;2019-12-31;2018;MILES;37730457;24182476;13547981;5335457;43163;8169361;872902;58363;1022467;202480;9313655;2690325;6623330;
5666;900136638;2019-12-31;2019;MILES;990171560;378116747;612054813;86345657;44506868;481202288;5187653;17641362;1001120;496057;459947960;72949822;386998138;
5667;900136638;2019-12-31;2018;MILES;1094733095;286798661;807934434;102466609;55131793;650336032;9883093;6519983;1121735;45691592;680830446;95921321;584909125;
5668;860038556;2019-12-31;2019;MILES;6214553;2228877;3985676;3949743;0;35933;223334;1502;308551;702860;822508;317300;505208;
5669;860038556;2019-12-31;2018;MILES;7499815;2717259;4782556;3837273;56288;888995;350557;0;650232;462590;1651260;611102;1040158;
5670;830002571;2019-12-31;2019;MILES;13951594;268646;13682948;13140973;0;541975;0;594678;0;692412;639709;277686;362023;
5671;830002571;2019-12-31;2018;MILES;13452948;179929;13273019;13064094;0;208925;29749;429452;191190;353100;294014;226010;68004;
5672;860006160;2019-12-31;2019;MILES;219804141;181653296;38150845;15227096;14282118;8641631;6578576;575811;288905;9324701;11100850;5609262;5491588;
5673;860006160;2019-12-31;2018;MILES;201078958;174022753;27056205;11028394;13097257;2930554;7101135;506354;1047786;8189783;4560634;2123325;2437309;
5674;890318932;2019-12-31;2019;MILES;96575;22722;73853;67985;0;5868;48019;1143451;272737;530280;-382585;65281;-447866;
5675;890318932;2019-12-31;2018;MILES;119874;28883;90991;195966;37;-105012;71147;140054;175371;8040504;7899662;425829;7473833;
5676;860520344;2019-12-31;2019;MILES;6350424;0;6350424;4973414;0;1377010;1339472;485744;1116267;214245;-14327524;462480;-14790004;
5677;860520344;2019-12-31;2018;MILES;5543602;0;5543602;4505544;0;1038058;1399634;243239;1896127;28955389;28195542;2076652;26118890;
5678;860004922;2019-12-31;2019;MILES;737576279;492229100;245347179;58944203;0;186402976;26061729;155898239;0;0;10907598;5065774;5841824;
5679;860004922;2019-12-31;2018;MILES;712636684;459544958;253091726;62452427;0;190639299;30870744;157702751;0;0;5843689;3034976;2808713;
5680;860005050;2019-12-31;2019;MILES;541187594;386870820;154316774;48103978;69534963;36677833;2123533;855913;997334;9853078;47391823;15694036;31697787;
5681;860005050;2019-12-31;2018;MILES;509212517;383606799;125605718;34868571;60950739;29786408;1761025;702811;761929;6404344;42378851;12039299;30339552;
5682;900470460;2019-12-31;2019;MILES;4563073;4538213;24860;155454;88326;-218920;0;10020;96654;248812;116526;0;116526;
5683;900470460;2019-12-31;2018;MILES;341065;2563;338502;145169;0;193333;0;10550;984;36229;219996;0;219996;
5684;800085445;2019-12-31;2019;MILES;91550129;74857231;16692898;2526697;2477159;11689042;5199716;759794;0;4120244;9849776;3070013;6779763;
5685;800085445;2019-12-31;2018;MILES;81620105;70583587;11036518;2232711;2122111;6681696;5738031;646605;0;2513752;2810812;1520533;1290279;
5686;860451192;2019-12-31;2019;MILES;5134872;0;5134872;1811371;0;3323501;0;0;0;0;3777852;1267271;2510581;
5687;860451192;2019-12-31;2018;MILES;3667472;0;3667472;1190400;0;2477072;0;0;0;0;2557274;918322;1638952;
5688;890900148;2019-12-31;2019;MILES;532688058;369871606;162816452;29985364;91445720;41385368;10096246;4320046;10623768;4549908;45962181;13298198;32663983;
5689;890900148;2019-12-31;2018;MILES;481019199;335452236;145566963;32764156;88374933;24427874;12378225;4292263;9440833;4261706;13405375;6253164;7152211;
5690;890307530;2019-12-31;2019;MILES;10128993;0;10128993;864746;0;9264247;20044;525;380471;1392;9625541;622298;9003243;
5691;890307530;2019-12-31;2018;MILES;8561425;0;8561425;305725;0;8255700;22817;2057;1030182;3633360;12894368;573770;12320598;
5692;830018654;2019-12-31;2019;MILES;13136129;1238061;11898068;3561903;0;8336165;0;6618624;0;0;2347822;-64192;2412014;
5693;830018654;2019-12-31;2018;MILES;10582277;3041557;7540720;1941037;0;5599683;0;4020473;0;0;1847059;681727;1165332;
5694;806000179;2019-12-31;2019;MILES;299015544;132526267;166489277;133407024;76006026;-42923773;56398534;7197746;12265246;17887273;15392206;-44877693;60269899;
5695;806000179;2019-12-31;2018;MILES;277055991;130080416;146975575;121960433;71825241;-46810099;130756192;10254448;29913325;14112812;-159589461;-436295;-160866743;
5696;800179736;2019-12-31;2019;MILES;7914595;55888;7858707;6919721;782176;156810;134093;129369;11863;1584445;1489656;246687;1242969;
5697;800179736;2019-12-31;2018;MILES;9998634;294061;9704573;8108602;989015;606956;400244;256658;11088;1101834;1062976;374760;688216;
5698;900139415;2019-12-31;2019;MILES;0;1519832;-1519832;0;0;-1519832;0;441155;0;0;385977;4168804;-3782827;
5699;900139415;2019-12-31;2018;MILES;0;2251763;-2251763;0;0;-2251763;0;1638093;0;0;-1484811;717337;-2202148;
5700;890904224;2019-12-31;2019;MILES;617505000;503619000;113886000;52849000;19271000;41766000;27805000;0;3578000;179000;27392000;9924000;17468000;
5701;890904224;2019-12-31;2018;MILES;548208000;467060000;81148000;47097000;16117000;17934000;19531000;550000;6337000;0;6668000;1368000;5300000;
5702;802024439;2019-12-31;2019;MILES;664017968;836826849;-172808881;0;0;-172808881;9519503;198515934;0;0;-375233541;37008676;-412242217;
5703;802024439;2019-12-31;2018;MILES;603954862;612103011;-8148149;0;0;-8148149;6755856;0;0;71774921;60929525;28691276;32238249;
5704;800103090;2019-12-31;2019;MILES;262386254;280054746;-17668492;0;0;-17668492;17347075;0;0;29486150;-2203392;4448787;-6652179;
5705;800103090;2019-12-31;2018;MILES;323885268;301038154;22847114;0;0;22847114;9394798;0;0;12455523;28808937;21060616;7748321;
5706;811044853;2019-12-31;2019;MILES;0;0;0;717616;0;-717616;1;657;345089;0;37240111;112518;37127593;
5707;811044853;2019-12-31;2018;MILES;0;0;0;146115;0;-146115;4;556;148115;2;59611591;-82099;59693690;
5708;860510826;2019-12-31;2019;MILES;37658613;21403924;16254689;7411690;7133090;1709909;0;65910;0;191975;1835974;687145;1148829;
5709;860510826;2019-12-31;2018;MILES;35665731;20918592;14747139;7387849;6790748;568542;0;0;0;681191;1249733;477378;772355;
5710;900818921;2019-12-31;2019;MILES;6844554694;5411653373;1432901321;303639983;459080249;670181089;11958165;36693599;82648780;5660578;709838683;252790963;457047720;
5711;900818921;2019-12-31;2018;MILES;4679169803;3924150326;755019477;117851232;359841366;277326879;2852533;1374962;32465285;1068201;306632870;112287156;194345714;
5712;830012053;2019-12-31;2019;MILES;396722698;308388687;88334011;6630740;11855881;69847390;8801196;16478098;0;0;41666445;-3183124;44849569;
5713;830012053;2019-12-31;2018;MILES;375788223;295483247;80304976;11039805;9527739;59737432;8279001;8262779;0;0;43022933;31929032;11093901;
5714;800051838;2019-12-31;2019;MILES;46065298;40421936;5643362;2175113;2685364;782885;1956542;390572;1047419;360262;-156548;201416;-357964;
5715;800051838;2019-12-31;2018;MILES;54955304;47980634;6974670;2308426;2900593;1765651;940484;520086;332513;485009;1122603;337668;784935;
5716;890205645;2019-12-31;2019;MILES;410147466;277923356;132224110;20973559;15079732;96170819;14624759;25493980;0;0;56091404;9601168;46490236;
5717;890205645;2019-12-31;2018;MILES;250523231;139280359;111242872;20188887;10915125;80138860;10628225;22894870;0;0;46293771;12879770;33414001;
5718;900148720;2019-12-31;2019;MILES;9675757;6110975;3564782;12680221;0;-9115439;0;214825;0;180770;-9149494;-113697;-9035797;
5719;900148720;2019-12-31;2018;MILES;113826814;67797525;46029289;14654083;0;31375206;0;1103790;0;0;30271416;15167304;15104112;
5720;900192621;2019-12-31;2019;MILES;7891587;7508435;383152;136236;0;246916;715219;346825;149711;38877;-626540;99668;-726208;
5721;900192621;2019-12-31;2018;MILES;48482981;47756558;726423;379558;0;346865;634766;1440191;103922;1901420;277250;191266;85984;
5722;800228015;2019-12-31;2019;MILES;4158224;5724836;-1566612;1182890;0;-2749502;853118;0;277584;22571;-345446;-190407;-155039;
5723;800228015;2019-12-31;2018;MILES;4253703;5220367;-966664;1265210;0;-2231874;911491;0;255408;96570;-80367;-78412;-1955;
5724;900131471;2019-12-31;2019;MILES;25576501;0;25576501;6071828;0;19504673;2857706;314841;120639;565842;15533647;412744;15120903;
5725;900131471;2019-12-31;2018;MILES;86471168;0;86471168;6320784;0;80150384;4572545;5093607;1016010;1293776;66914105;885558;66028547;
5726;890300213;2019-12-31;2019;MILES;228809589;187793921;41015668;13291527;26629019;1095122;7205233;8957792;582741;1588350;-15869243;-4231113;-11638130;
5727;890300213;2019-12-31;2018;MILES;270093240;223015349;47077891;12889880;24529982;9658029;6245876;2639313;90850;2928939;5474743;2369392;3105351;
5728;800240724;2019-12-31;2019;MILES;182621738;165340683;17281055;7630511;0;9650544;1588155;532069;0;3670917;11201237;1855717;9345520;
5729;800240724;2019-12-31;2018;MILES;95017063;83494240;11522823;7906888;0;3615935;2133611;2442477;0;4939065;3978912;1780761;2198151;
5730;900877488;2019-12-31;2019;MILES;372587;98788;273799;198552;0;75247;18259;273570;1800643;496043;53618434;482407;53136027;
5731;900877488;2019-12-31;2018;MILES;1775032;1120130;654902;43410;0;611492;38745;491570;433960;37913836;98103289;188346;97914943;
5732;860005265;2019-12-31;2019;MILES;573470579;342758709;230711870;21019587;164889817;44802466;2118290;1530750;102583;1672005;31870368;13282905;18587463;
5733;860005265;2019-12-31;2018;MILES;526571987;321676813;204895174;20474213;149772872;34648089;1429934;195010;77100;1588929;23283388;11032911;12250477;
5734;900317003;2019-12-31;2019;MILES;284131685;0;284131685;942274;0;283189411;2063465;2310;422072;1;273545709;285824;273259885;
5735;900317003;2019-12-31;2018;MILES;0;0;0;652480;0;-652480;474032;0;305181;158766837;157945506;110887;157834619;
5736;890900016;2019-12-31;2019;MILES;171681591;145437839;26243752;7383365;16459897;2400490;3317742;221751;312075;2529270;1634952;633730;1001222;
5737;890900016;2019-12-31;2018;MILES;140738113;119862588;20875525;4612202;13805878;2457445;3860556;399839;392902;2052353;2744359;796879;1947480;
5738;800141695;2019-12-31;2019;MILES;64724412;51362592;13361820;5871550;740507;6749763;3853477;416692;179250;1253317;3892776;1216511;2676265;
5739;800141695;2019-12-31;2018;MILES;50801311;43812582;6988729;5745390;661427;581912;1391893;412361;470299;90640;3249594;-235880;3485474;
5740;900838638;2019-12-31;2019;MILES;0;0;0;1903128;0;-1903128;290489;0;0;0;-1647829;0;-1647829;
5741;900838638;2019-12-31;2018;MILES;0;0;0;394213;0;-394213;405997;0;0;0;6046571;0;6046571;
5742;805031746;2019-12-31;2019;MILES;0;0;0;2119;0;-2119;0;0;7179;0;2880;600;2280;
5743;805031746;2019-12-31;2018;MILES;0;0;0;2000;0;-2000;0;0;4291;0;2381;0;2381;
5744;900007440;2019-12-31;2019;MILES;11164083;6887650;4276433;347587;3789099;139747;155677;0;0;3878;-216086;33256;-249342;
5745;900007440;2019-12-31;2018;MILES;10491183;6584280;3906903;336936;3647905;-77938;25463;0;0;511;-991706;6204;-997910;
5746;800092723;2019-12-31;2019;MILES;40771682;32552080;8219602;2259855;4851617;1108130;951803;331341;40112;470565;355322;82157;273165;
5747;800092723;2019-12-31;2018;MILES;41349832;33041975;8307857;1927723;4635738;1744396;1022912;329866;3389;425380;818072;103231;714841;
5748;900120564;2019-12-31;2019;MILES;3864979;370000;3494979;1465288;0;2029691;1720961;93230;16316;629123;936905;200249;736656;
5749;900120564;2019-12-31;2018;MILES;2722705;0;2722705;620136;0;2102569;1914532;225073;11293;249763;2718449;499684;2218765;
5750;860020439;2019-12-31;2019;MILES;729070708;654566721;74503987;56812819;45228449;-27537281;14929187;0;4802265;7997248;-22653942;3138762;-25792704;
5751;860020439;2019-12-31;2018;MILES;977047394;921839841;55207553;57193052;62111097;-64096596;25153401;0;2953648;9350514;-74642235;-7946004;-66696231;
5752;900195679;2019-12-31;2019;MILES;27852208;21679686;6172522;3609976;5424225;-2861679;2442476;126492;99555;5897;-5325195;-33539;-5291656;
5753;900195679;2019-12-31;2018;MILES;23888662;22293482;1595180;2961756;2846845;-4213421;1621990;81750;224776;55397;-5636988;176737;-5813725;
5754;830002366;2019-12-31;2019;MILES;692600896;360617396;331983500;40831472;248177718;42974310;14055611;37606570;0;0;-8948043;3463937;-12411980;
5755;830002366;2019-12-31;2018;MILES;618380279;323324673;295055606;39661786;218503459;36890361;10696212;23661006;0;0;3532256;807633;2724623;
5756;890900135;2019-12-31;2019;MILES;109310963;71175751;38135212;4051423;7811188;26272601;1227052;646276;0;1205311;24238835;9155640;15083195;
5757;890900135;2019-12-31;2018;MILES;100905250;72163005;28742245;3417810;7280893;18043542;1010740;449245;0;1174600;17344022;6361605;10982417;
5758;860015753;2019-12-31;2019;MILES;901615460;736950868;164664592;46450945;166589957;-48376310;1020000;0;114500;0;-28504212;-10176025;-18328187;
5759;860015753;2019-12-31;2018;MILES;845116298;667807445;177308853;57836735;160147000;-40674882;12070856;5163000;7460056;0;37944226;-9051239;46995465;
5760;900548188;2019-12-31;2019;MILES;130936;2525865;-2394929;274725;0;-2669654;655959;1278112;1058694;0;-7746354;442292;-8188646;
5761;900548188;2019-12-31;2018;MILES;126901;2526618;-2399717;222639;0;-2622356;5428048;1237;4110193;0;-9755190;475786;-10230976;
5762;900646251;2019-12-31;2019;MILES;19934305;17677374;2256931;5037815;1639348;-4420232;1171421;2945;18609;0;-5086871;502566;-5589437;
5763;900646251;2019-12-31;2018;MILES;26854029;21066062;5787967;5482129;1909378;-1603540;730752;1746534;89326;378317;-3613183;852101;-4465284;
5764;860034335;2019-12-31;2019;MILES;30004619;22006180;7998439;5893096;630047;1475296;391523;166905;25582;92229;373109;293320;79789;
5765;860034335;2019-12-31;2018;MILES;21175209;17113179;4062030;2747768;754491;559771;326085;757776;229357;688976;394243;392833;1410;
5766;830068965;2019-12-31;2019;MILES;0;0;0;108592;0;-108592;11538;402980;2190415;313697;-1791586;1268815;-3060401;
5767;830068965;2019-12-31;2018;MILES;0;0;0;230280;0;-230280;5057;2741621;1482063;615282;17412483;5304789;12107694;
5768;890209207;2019-12-31;2019;MILES;30063895;21969433;8094462;717022;4031466;3345974;285707;259436;23792;163256;3858272;1183542;2674730;
5769;890209207;2019-12-31;2018;MILES;17400033;13040855;4359178;595826;2386647;1376705;295200;354307;6805;187027;1810511;348731;1461780;
5770;900683456;2019-12-31;2019;MILES;688787;356323;332464;112367;0;220097;0;1247;126764;111619;457233;32469;424764;
5771;900683456;2019-12-31;2018;MILES;2740112;2323001;417111;204292;0;212819;0;137173;70556;59046;205248;38011;167237;
5772;830010337;2019-12-31;2019;MILES;888139123;559851094;328288029;82639485;200677918;44970626;2267219;0;382786;36155081;80027492;18407428;61620064;
5773;830010337;2019-12-31;2018;MILES;849334398;488744958;360589440;71049399;207490436;82049605;2812577;5016030;487303;0;74849619;29151950;45697669;
5774;860351923;2019-12-31;2019;MILES;33983393;25976415;8006978;2742699;632487;4631792;1825540;0;479651;175972;3461875;1095126;2366749;
5775;860351923;2019-12-31;2018;MILES;28939055;23027457;5911598;2048200;599574;3263824;1494179;0;596616;176631;2542892;1349566;1193326;
5776;890911585;2019-12-31;2019;MILES;9118370;5425716;3692654;3293618;3611298;-3212262;603794;2858737;79448;1203840;-5302306;38510;-5340816;
5777;890911585;2019-12-31;2018;MILES;9223793;1892558;7331235;3446745;3315529;568961;989784;331027;36950;920252;205352;49012;156340;
5778;890211777;2019-12-31;2019;MILES;220762394;116694802;104067592;6155221;6702831;91209540;11828282;6593467;0;0;71602391;9461231;62141160;
5779;890211777;2019-12-31;2018;MILES;286597769;171841630;114756139;14327767;6582564;93845808;11898782;7703327;0;0;74105218;16990675;57114543;
5780;832010019;2019-12-31;2019;MILES;46007841;45329290;678551;0;0;678551;96793;284751;45880;186860;535290;343675;191615;
5781;832010019;2019-12-31;2018;MILES;48630487;47197237;1433250;0;0;1433250;261941;326468;214696;806183;1872888;-107030;1979918;
5782;891902805;2019-12-31;2019;MILES;122540202;107713902;14826300;1039036;8978898;4808366;1718100;0;0;1031641;4121907;1559924;2561983;
5783;891902805;2019-12-31;2018;MILES;109861197;94430348;15430849;1163830;11292160;2974859;1351280;0;0;1052088;2675667;1123577;1552090;
5784;860008234;2019-12-31;2019;MILES;18536055;0;18536055;679003;0;17857052;23166;3000;0;0;1855880;39195;1816685;
5785;860008234;2019-12-31;2018;MILES;21093081;0;21093081;1152180;0;19940901;61643;6780;0;0;-23871797;239237;-24111034;
5786;900117010;2019-12-31;2019;MILES;6742352;5775979;966373;700980;0;265393;75071;106362;0;38422;122382;40386;81996;
5787;900117010;2019-12-31;2018;MILES;13012565;12018170;994395;805792;0;188603;191517;64986;4347;70681;7128;13832;-6704;
5788;900712197;2019-12-31;2019;MILES;2109800;0;2109800;2252916;0;-143116;0;59477;33452;99724;-69417;3590;-73007;
5789;900712197;2019-12-31;2018;MILES;1618293;0;1618293;1582695;0;35598;0;24087;17125;15116;43752;33787;9965;
5790;900377636;2019-12-31;2019;MILES;1688160;0;1688160;122312;0;1565848;4522;226791;5916;504633;1845084;156134;1688950;
5791;900377636;2019-12-31;2018;MILES;452880;0;452880;306110;0;146770;4022;136594;97081;172592;275827;-398469;674296;
5792;890923500;2019-12-31;2019;MILES;85218;45945;39273;126997;2972;-90696;22107;278582;995;11244;-200619;17051;-217670;
5793;890923500;2019-12-31;2018;MILES;172052;51066;120986;130830;149;-9993;23964;70223;303;154454;50577;393053;-342476;
5794;900218736;2019-12-31;2019;MILES;59713194;34259147;25454047;12896041;1812935;10745071;1867448;8523533;0;1240683;2832737;847005;1985732;
5795;900218736;2019-12-31;2018;MILES;51269133;24221034;27048099;12503386;1326382;13218331;3432591;7797036;0;1917219;5025718;1575958;3449760;
5796;900311215;2019-12-31;2019;MILES;1157506;0;1157506;1949816;133975;-926285;706656;0;0;327974;-987183;84978;-1072161;
5797;900311215;2019-12-31;2018;MILES;1205608;0;1205608;1790513;116567;-701472;713419;0;0;1094935;-319956;118493;-438449;
5798;901040044;2019-12-31;2019;MILES;7620221;0;7620221;6817431;0;802790;0;0;84866;39998;927654;336330;591324;
5799;901040044;2019-12-31;2018;MILES;31466;0;31466;25780;0;5686;0;17588;11678;5902;5678;3814;1864;
5800;860048521;2019-12-31;2019;MILES;47321601;38304864;9016737;4658086;2358833;1999818;1324658;0;837475;794706;2383729;904037;1479692;
5801;860048521;2019-12-31;2018;MILES;40281523;32627667;7653856;4053779;2174670;1425407;1581022;0;901568;858699;1604652;414917;1189735;
5802;890932424;2019-12-31;2019;MILES;329391746;266164803;63226943;11987297;0;51239646;14657055;675522;11072699;2697744;47950675;10942877;37007798;
5803;890932424;2019-12-31;2018;MILES;159207711;125992077;33215634;10396304;0;22819330;8355316;1126876;9364362;2122449;25400649;-1821451;27222100;
5804;860003168;2019-12-31;2019;MILES;119018343;84178943;34839400;13709963;27751232;-6621795;2101198;894812;1093372;8556635;-289061;568778;-857839;
5805;860003168;2019-12-31;2018;MILES;98195775;67506002;30689773;11487070;27548764;-8346061;1076334;676771;1242679;7724790;-2131018;-271252;-1859766;
5806;860524118;2019-12-31;2019;MILES;40492772;26197415;14295357;13018487;0;1276870;0;617473;262212;421430;1354409;219;1354190;
5807;860524118;2019-12-31;2018;MILES;14459724;2626521;11833203;11778194;0;55009;0;1571808;124899;9723149;8357247;398325;7958922;
5808;900916121;2019-12-31;2019;MILES;90808781;74989970;15818811;9352606;2469643;3996562;2035032;0;0;12340;22219997;4665311;17554686;
5809;900916121;2019-12-31;2018;MILES;88079475;67304259;20775216;9167381;2515950;9091885;680681;0;0;109505;8023995;-446467;8470462;
5810;830038885;2019-12-31;2019;MILES;10876266;0;10876266;43202135;0;-32325869;18440288;25240587;2392184;50336;40840850;1069875;39770975;
5811;830038885;2019-12-31;2018;MILES;280380039;149063847;131316192;42111074;0;89205118;35786590;13511235;14347268;1567;195267617;863423;194404194;
5812;890903279;2019-12-31;2019;MILES;118669813;97859890;20809923;29891702;310090;-9391869;0;1590805;52069;25015361;14084756;2808351;11276405;
5813;890903279;2019-12-31;2018;MILES;101706223;83208279;18497944;27307698;228930;-9038684;0;951803;47521;28345995;18403029;5594192;12808837;
5814;900464054;2019-12-31;2019;MILES;0;0;0;117793000;0;-117793000;267406000;0;2549000;3153000;873188000;150016000;723172000;
5815;900464054;2019-12-31;2018;MILES;0;0;0;99286000;0;-99286000;135843000;0;1361000;2542000;349212000;-12537000;361749000;
5816;900966568;2019-12-31;2019;MILES;82074251;40625009;41449242;6559279;339731;34550232;0;0;350571;0;36106639;12535392;23571247;
5817;900966568;2019-12-31;2018;MILES;117257677;42437949;74819728;6047639;253326;68518763;0;0;453774;0;68614155;25570378;43043777;
5818;811036875;2019-12-31;2019;MILES;70024641;0;70024641;51063894;7382672;11578075;0;3860250;148935;33742969;41609729;10213770;31395959;
5819;811036875;2019-12-31;2018;MILES;65937799;0;65937799;59966714;5931218;39867;64355;3715651;0;40904733;37164594;9632794;27531800;
5820;890318250;2019-12-31;2019;MILES;174963;0;174963;850131;0;-675168;102438;4821;0;141884;-2602546;-86784;-2515762;
5821;890318250;2019-12-31;2018;MILES;77054;0;77054;116734;0;-39680;237628;43506;0;2239;-4371658;-86489;-4285169;
5822;900470452;2019-12-31;2019;MILES;21852681;19451256;2401425;481962;538503;1380960;16954;43785;34526;4075;1358822;346153;1012669;
5823;900470452;2019-12-31;2018;MILES;5827905;5888646;-60741;592511;580101;-1233353;8061;23503;65761;124916;-1074240;14632;-1088872;
5824;891304818;2019-12-31;2019;MILES;45651432;25253125;20398307;4432876;15363328;602103;175675;1761284;0;3167020;1832164;0;1832164;
5825;891304818;2019-12-31;2018;MILES;39956358;22538993;17417365;3907988;13967545;-458168;88375;1533655;0;6837590;4757392;0;4757392;
5826;830049252;2019-12-31;2019;MILES;0;0;0;104205;0;-104205;0;1;0;0;13553373;0;13553373;
5827;830049252;2019-12-31;2018;MILES;0;0;0;0;0;0;0;3571;0;0;28155290;1429;28153861;
5828;890903055;2019-12-31;2019;MILES;102775028;87668258;15106770;11271647;3821489;13634;2673717;2729042;1988564;1867046;3812870;-365280;4178150;
5829;890903055;2019-12-31;2018;MILES;89297069;71936516;17360553;10968298;4708375;1683880;1548459;6942526;6555942;1848345;2341508;1149146;1192362;
5830;805023991;2019-12-31;2019;MILES;0;0;0;82801;0;-82801;130922;0;129014;0;1049652;-131394;1181046;
5831;805023991;2019-12-31;2018;MILES;0;0;0;88510;0;-88510;126018;0;73770;0;1332735;178750;1153985;
5832;890903910;2019-12-31;2019;MILES;161942702;0;161942702;159979541;7880373;-5917212;1793345;2299199;2323519;6549958;-22264359;1445567;-23709926;
5833;890903910;2019-12-31;2018;MILES;166614727;0;166614727;160479091;8403663;-2268027;1734738;3916413;2873317;4725010;-70457698;707420;-71165118;
5834;800130426;2019-12-31;2019;MILES;824190761;707415992;116774769;2847854;59210626;54716289;20587108;105690;1439958;1428915;39099681;10591238;28508443;
5835;800130426;2019-12-31;2018;MILES;814357908;690537009;123820899;3476034;65806574;54538291;31245977;99365;2016668;1399619;27909649;15287234;12622415;
5836;860009626;2019-12-31;2019;MILES;769302;0;769302;141682;0;627620;338;0;28;72;627382;200660;426722;
5837;860009626;2019-12-31;2018;MILES;745592;0;745592;202314;0;543278;1558;0;354;0;542074;179149;362925;
5838;890926345;2019-12-31;2019;MILES;150843;0;150843;25002;0;125841;1571;0;29;3;218915;41254;177661;
5839;890926345;2019-12-31;2018;MILES;146194;0;146194;22026;0;124168;747;637;85;0;203337;40894;162443;
5840;860350697;2019-12-31;2019;MILES;848276139;845669267;2606872;9649238;9759077;-16801443;7369478;2738013;3954709;42826739;19598814;2868408;16730406;
5841;860350697;2019-12-31;2018;MILES;866332591;854650793;11681798;8468945;8135262;-4922409;2302192;2791235;2261699;5303343;-2703355;-4050756;1347401;
5842;860502509;2019-12-31;2019;MILES;233026281;177093180;55933101;12455006;33730126;9747969;10254186;382586;3658539;1240705;4010441;-1965711;5976152;
5843;860502509;2019-12-31;2018;MILES;207022705;151854658;55168047;17521893;28179249;9466905;7675543;658092;44459;3491407;4669136;-2080834;6749970;
5844;811025446;2019-12-31;2019;MILES;74410478;48275042;26135436;14978637;25774069;-14617270;3748271;0;290330;0;-17706274;-391809;-17314465;
5845;811025446;2019-12-31;2018;MILES;65614022;41177306;24436716;12389285;28590839;-16543408;3233444;0;123739;0;-16232746;1477796;-17710542;
5846;800106129;2019-12-31;2019;MILES;4976508;0;4976508;1191705;6004;3778799;2637;686301;0;224247;3314108;-157536;3471644;
5847;800106129;2019-12-31;2018;MILES;4639509;0;4639509;1149623;35001;3454885;3047;81958;1548;26;3357489;-3770799;7128288;
5848;891300671;2019-12-31;2019;MILES;15834474;6280356;9554118;3373341;205872;5974905;1395556;466109;6483;0;1427010;-90923;1517933;
5849;891300671;2019-12-31;2018;MILES;11481782;6945347;4536435;4139416;238448;158571;1314992;520856;16207;0;708614;221100;487514;
5850;900329889;2019-12-31;2019;MILES;0;0;0;1351237;0;-1351237;21065473;189838;1808102;1394168;-20540950;384590;-20925540;
5851;900329889;2019-12-31;2018;MILES;0;17500000;-17500000;2602242;0;-20102242;24883084;3987515;5871225;1617320;-43219535;1748012;-44967547;
5852;860056785;2019-12-31;2019;MILES;2087736;742960;1344776;1376457;0;-31681;0;17316;0;636244;587247;103333;483914;
5853;860056785;2019-12-31;2018;MILES;2150714;772275;1378439;1273218;0;105221;0;62613;0;468804;511412;94355;417057;
5854;860530547;2019-12-31;2019;MILES;366583429;257372363;109211066;29425189;42397544;37388333;18676163;612782;191029;2905289;18254621;7578642;10675979;
5855;860530547;2019-12-31;2018;MILES;355364557;263000755;92363802;28997073;41307936;22058793;17066721;978081;1870564;3382047;6208434;6455739;-247305;
5856;901239514;2019-12-31;2019;MILES;0;0;0;28520;0;-28520;0;931;0;0;18606512;108567309;-89960797;
5857;901239514;2019-12-31;2018;MILES;0;0;0;58708;0;-58708;0;0;0;0;-58708;0;-58708;
5858;860031361;2019-12-31;2019;MILES;82622329;118732425;-36110096;14363400;2644922;-53118418;4149293;391514;2172172;2838961;-53480266;3592732;-57072998;
5859;860031361;2019-12-31;2018;MILES;120704341;100231677;20472664;12107508;1545795;6819361;4872811;2378884;1859550;979424;2368333;1050852;1317481;
5860;890320250;2019-12-31;2019;MILES;79821394;48912958;30908436;2778008;7824449;20305979;2382729;0;87953;0;19495378;5342607;14152771;
5861;890320250;2019-12-31;2018;MILES;74993564;48008279;26985285;2485658;7383304;17116323;2896294;0;611077;0;15437981;5120153;10317828;
5862;800032229;2019-12-31;2019;MILES;0;0;0;31609;0;-31609;0;47834;0;29695;-2142734;2806;-2145540;
5863;800032229;2019-12-31;2018;MILES;7024;0;7024;18687;0;-11663;0;13640;0;0;-1744904;2152;-1747056;
5864;890301443;2019-12-31;2019;MILES;11812084;8685863;3126221;3879020;921138;-1673937;4112410;328708;8662737;137530;6506983;-1144236;7651219;
5865;890301443;2019-12-31;2018;MILES;63818710;3115402;60703308;3555218;1139200;56008890;18355151;520683;13800737;68175;101905314;212008;101693306;
5866;890318919;2019-12-31;2019;MILES;170152558;108623143;61529415;14810536;34241367;12477512;0;10435484;0;1881322;4152310;1745738;2406572;
5867;890318919;2019-12-31;2018;MILES;163393952;101946482;61447470;13779908;32597925;15069637;0;9973983;0;1186744;8402337;3144910;5257427;
5868;800249542;2019-12-31;2019;MILES;27019219;0;27019219;4401597;23115;22594507;5851;0;0;89182;11081861;71491;11010370;
5869;800249542;2019-12-31;2018;MILES;23177790;0;23177790;3257412;16696;19903682;2961;0;0;77708;14542935;273190;14269745;
5870;900333530;2019-12-31;2019;MILES;603317023;681541435;-78224412;21173224;116333795;-215731431;29026798;193871;144425;1003520;-242023143;30324210;-272347353;
5871;900333530;2019-12-31;2018;MILES;846441260;582931974;263509286;10566332;114592060;138350894;56204198;525091;102119;79472;89632741;48685886;40946855;
5872;860035977;2019-12-31;2019;MILES;23007485;0;23007485;23306407;0;-298922;59008;0;0;147853;-2056743;-31022;-2025721;
5873;860035977;2019-12-31;2018;MILES;21276584;0;21276584;22053018;0;-776434;47166;0;0;210324;-776399;1023;-777422;
5874;800185347;2019-12-31;2019;MILES;23114452;0;23114452;12786012;194524;10133916;2387046;0;0;4927632;12674502;1390188;11284314;
5875;800185347;2019-12-31;2018;MILES;21579561;358323;21221238;13756454;86172;7378612;1784186;0;0;0;8185085;1335313;6849772;
5876;860002688;2019-12-31;2019;MILES;4160181;0;4160181;13140182;0;-8980001;564682;3596916;11588;189248;95746359;-108620;95854979;
5877;860002688;2019-12-31;2018;MILES;4156196;0;4156196;14410681;0;-10254485;0;4382984;0;660869;64614340;875537;63738803;
5878;800093117;2019-12-31;2019;MILES;456770542;345385865;111384677;53055457;0;58329220;12406628;0;0;0;45922592;17349706;28572886;
5879;800093117;2019-12-31;2018;MILES;457849028;352763807;105085221;50418422;0;54666799;0;9025445;0;0;45641354;22953231;22688123;
5880;820003863;2019-12-31;2019;MILES;21801795;19319795;2482000;519036;0;1962964;87366;348070;8271;267972;1803771;619792;1183979;
5881;820003863;2019-12-31;2018;MILES;25029667;22501579;2528088;454005;0;2074083;122466;50688;7639;86987;1995555;734076;1261479;
5882;890309577;2019-12-31;2019;MILES;8136614;4000150;4136464;2007573;1360286;768605;307008;179530;39989;272290;703220;277177;426043;
5883;890309577;2019-12-31;2018;MILES;7074264;2592057;4482207;2650389;1334491;497327;273092;267928;27110;225187;208604;-30291;238895;
5884;900478901;2019-12-31;2019;MILES;4500972;0;4500972;137121;0;4363851;2049040;0;0;0;2314811;1092063;1222748;
5885;900478901;2019-12-31;2018;MILES;4924033;695107;4228926;828374;0;3400552;2084712;0;34082;695107;2045029;679804;1365225;
5886;900601507;2019-12-31;2019;MILES;0;0;0;488585;0;-488585;42751491;0;59908692;3464081;20132697;875927;19256770;
5887;900601507;2019-12-31;2018;MILES;0;0;0;1633538;0;-1633538;31954110;0;42646583;3052904;12111839;2450049;9661790;
5888;890927442;2019-12-31;2019;MILES;19918;0;19918;40505;0;-20587;4385;83;0;4822;2014324;173731;1840593;
5889;890927442;2019-12-31;2018;MILES;18278;0;18278;45463;0;-27185;166;11;0;1293;881910;542;881368;
5890;890903939;2019-12-31;2019;MILES;1924968767;950865349;974103418;211965459;524902564;237235395;64323721;0;3338501;0;147386436;55863810;91522626;
5891;890903939;2019-12-31;2018;MILES;1750382430;900227054;850155376;199111805;440899793;210143778;58736107;0;2213395;0;115492246;48301679;67190567;
5892;900138670;2019-12-31;2019;MILES;417379493;407102478;10277015;5514168;0;4762847;13356047;708985;8964843;876374;994886;856264;138622;
5893;900138670;2019-12-31;2018;MILES;597930752;580025061;17905691;8307607;0;9598084;11037140;1107708;5757862;999078;5593606;2088662;3504944;
5894;815001802;2019-12-31;2019;MILES;68210252;50002032;18208220;2405769;12168167;3634284;1433445;429704;51431;0;1756962;1026557;730405;
5895;815001802;2019-12-31;2018;MILES;57852396;44342814;13509582;2206304;8801858;2501420;1700956;197921;305809;0;1056006;96813;959193;
5896;900498388;2019-12-31;2019;MILES;4677185;3839063;838122;538708;0;299414;777841;3224;0;736;-480915;15717;-496632;
5897;900498388;2019-12-31;2018;MILES;405203;0;405203;214560;0;190643;646628;8775;0;283211;-181549;54551;-236100;
5898;860015826;2019-12-31;2019;MILES;4072733;1445161;2627572;158399;1209626;1259547;0;260277;0;263467;1262744;467788;794956;
5899;860015826;2019-12-31;2018;MILES;2289653;549511;1740142;180341;924983;634818;0;42935;0;127178;721546;264002;457544;
5900;860350543;2019-12-31;2019;MILES;77141842;47641703;29500139;2559146;4632830;22308163;1076372;50818;663097;203276;22966923;7531701;15435222;
5901;860350543;2019-12-31;2018;MILES;47093453;27649176;19444277;2427965;3413871;13602441;242176;8911;739960;78099;15177471;5219976;9957495;
5902;890302629;2019-12-31;2019;MILES;206123656;173887075;32236581;10142538;10674322;11419721;436629;3704914;202582;2682810;10571068;4429632;6141436;
5903;890302629;2019-12-31;2018;MILES;171253381;151027481;20225900;9414046;10191088;620766;724683;2515549;193296;2344168;248850;-1486255;1735105;
5904;900696296;2019-12-31;2019;MILES;47715743;0;47715743;30752041;0;16963702;14161293;556870;471865;0;-46484364;1725537;-48209901;
5905;900696296;2019-12-31;2018;MILES;37496817;0;37496817;28044955;0;9451862;9076462;710616;37868;1986112;-62443881;3582013;-66025894;
5906;860076228;2019-12-31;2019;MILES;20493143;12907305;7585838;3186496;2065856;2333486;1862581;212574;119563;205592;583486;216686;366800;
5907;860076228;2019-12-31;2018;MILES;25486723;17872122;7614601;3004599;2448050;2161952;2725943;330114;57983;444604;1007848;587204;420644;
5908;800017113;2019-12-31;2019;MILES;19102718;15129231;3973487;2398980;214508;1359999;0;1720924;0;155282;-205643;-282676;77033;
5909;800017113;2019-12-31;2018;MILES;6207713;2156047;4051666;2726601;219441;1105624;0;3302387;0;328056;-1868707;-510177;-1358530;
5910;891409156;2019-12-31;2019;MILES;39407906;31394114;8013792;3096564;4611870;305358;2159405;1305444;4911;12830497;10154187;1197627;8956560;
5911;891409156;2019-12-31;2018;MILES;42466818;31254068;11212750;2785461;4113113;4314176;1783843;1589631;148791;4067430;5490493;824763;4665730;
5912;900074316;2019-12-31;2019;MILES;112502497;72686202;39816295;11621318;3854484;24340493;1578257;931387;423338;409302;22827606;8235046;14592560;
5913;900074316;2019-12-31;2018;MILES;70877863;46038539;24839324;8501266;2973359;13364699;1258169;668615;91817;266986;15252789;4358263;10894526;
5914;860025792;2019-12-31;2019;MILES;3006724239;2593492555;413231684;67056915;223411861;122762908;11858009;9055409;1453273;0;93071335;39945661;53125674;
5915;860025792;2019-12-31;2018;MILES;2655492403;2264209617;391282786;65117956;213860275;112304555;3775581;5602999;1826981;0;89128787;30850455;58278332;
5916;890917007;2019-12-31;2019;MILES;119706517;101307522;18398995;12026296;2691011;3681688;1309384;18766;132830;214076;2700444;1372776;1327668;
5917;890917007;2019-12-31;2018;MILES;187321516;167057100;20264416;12227614;3037062;4999740;778361;135654;268737;1969390;6610822;807185;5803637;
5918;830011100;2019-12-31;2019;MILES;7004316;1096411;5907905;4939313;0;968592;0;785454;0;1083121;1266259;335452;930807;
5919;830011100;2019-12-31;2018;MILES;6384112;1105397;5278715;4598768;0;679947;0;635483;0;964427;1008891;240761;768130;
5920;800182204;2019-12-31;2019;MILES;26588032;23009664;3578368;1695221;331614;1551533;155683;14665;45273;0;1396610;161523;1235087;
5921;800182204;2019-12-31;2018;MILES;53657722;46538144;7119578;1595702;305114;5218762;107160;25250;65946;0;5724626;340935;5383691;
5922;890900168;2019-12-31;2019;MILES;622343245;161292779;461050466;73619282;68392455;319038729;5523310;21189968;985894;1245431;350173380;91716044;258457336;
5923;890900168;2019-12-31;2018;MILES;701437389;137908117;563529272;128960373;54609266;379959633;3305981;15423311;5780571;17753157;448800833;135564262;313236571;
5924;900542692;2019-12-31;2019;MILES;3270286;0;3270286;35754;0;3234532;0;4672;0;6517;3236377;651;3235726;
5925;900542692;2019-12-31;2018;MILES;142350;0;142350;6458;0;135892;0;15196;0;10630;131326;3562;127764;
5926;860055182;2019-12-31;2019;MILES;51039925;43487714;7552211;13647196;0;-6094985;2276908;1252273;870101;2876896;-5877169;793822;-6670991;
5927;860055182;2019-12-31;2018;MILES;30135441;38920656;-8785215;16848650;0;-25633865;1429781;569283;91800;11247518;-16293611;466937;-16760548;
5928;891500202;2019-12-31;2019;MILES;118513605;97396237;21117368;125875;15781674;5209819;0;0;8748635;1375812;8799732;3635741;5163991;
5929;891500202;2019-12-31;2018;MILES;95380306;79131308;16248998;11110998;0;5138000;3871269;0;0;3211431;10428162;895477;9532685;
5930;830065609;2019-12-31;2019;MILES;121730991;94245285;27485706;7455874;24126659;-4096827;6553987;650871;3111457;299184;22405715;339502;22066213;
5931;830065609;2019-12-31;2018;MILES;104416695;88447356;15969339;7553910;15739958;-7324529;9838135;1508254;3537096;2463741;17498173;-1403228;18901401;
5932;890914597;2019-12-31;2019;MILES;20449502;9594368;10855134;1957759;4211964;4685411;0;3885808;0;3204517;4004120;798870;3205250;
5933;890914597;2019-12-31;2018;MILES;19636230;9353892;10282338;1904209;3881816;4496313;0;3062822;0;823921;2257412;846310;1411102;
5934;830094920;2019-12-31;2019;MILES;148966365;105837308;43129057;20648251;1277991;21202815;7346633;3384133;22314357;26111605;105613553;23873426;81740127;
5935;830094920;2019-12-31;2018;MILES;153402608;110742773;42659835;23124260;1564404;17971171;8776368;7302928;15502042;26378830;85996201;5775706;80220495;
5936;860012340;2019-12-31;2019;MILES;34388984;18121557;16267427;3715188;6093335;6458904;5130237;69500;4020847;175223;6600234;2019000;4581234;
5937;860012340;2019-12-31;2018;MILES;29929516;16120349;13809167;3200261;5299218;5309688;3481632;53648;2588240;221952;5732549;1714000;4018549;
5938;890205459;2019-12-31;2019;MILES;326677;0;326677;237019;0;89658;4862;9856;13623;5620;94183;-1373;95556;
5939;890205459;2019-12-31;2018;MILES;515515;247032;268483;206690;0;61793;438;27525;31793;1057;66680;26539;40141;
5940;900419613;2019-12-31;2019;MILES;5905005;2894946;3010059;4148016;0;-1137957;0;237038;0;742783;-632212;314184;-946396;
5941;900419613;2019-12-31;2018;MILES;7207541;3477195;3730346;2216906;0;1513440;0;1604870;0;973832;882402;291232;591170;
5942;800202306;2019-12-31;2019;MILES;1775732;1766846;8886;364693;0;-355807;0;86600;0;8971;-433436;1865;-435301;
5943;800202306;2019-12-31;2018;MILES;1825108;1557203;267905;380590;0;-112685;0;15933;0;338;-128280;1319;-129599;
5944;901034906;2019-12-31;2019;MILES;7610756;10044672;-2433916;848088;215012;-3497016;0;114103;491274;43270;11765224;0;11765224;
5945;901034906;2019-12-31;2018;MILES;7384260;9287252;-1902992;1668409;109735;-3681136;0;108986;97624;67103;11430739;0;11430739;
5946;900087151;2019-12-31;2019;MILES;1859291;0;1859291;1111635;0;747656;7897826;7;172196;50000;235632412;920501;234711911;
5947;900087151;2019-12-31;2018;MILES;1801988;0;1801988;986652;0;815336;16399803;69241;83758;20000;148941474;-431776;149373250;
5948;811043033;2019-12-31;2019;MILES;389719;0;389719;383712;0;6007;191437;43918;220041;70728;61421;79674;-18253;
5949;811043033;2019-12-31;2018;MILES;808361;0;808361;2108161;0;-1299800;117315;257330;1705091;42491;73137;63425;9712;
5950;800153993;2019-12-31;2019;MILES;12672156258;4583807611;8088348647;3203575032;0;4884773615;645066262;2296956998;160565048;0;2117266929;915286252;1201980677;
5951;800153993;2019-12-31;2018;MILES;8009741443;3236419515;4773321928;2140813955;0;2632507973;914384713;1158750027;73651698;295438819;1289074944;246726388;1042348556;
5952;900023333;2019-12-31;2019;MILES;804264810;0;804264810;1238455;0;803026355;0;0;58703309;0;861729664;18799187;842930477;
5953;900023333;2019-12-31;2018;MILES;723911072;0;723911072;698927;0;723212145;0;0;52907395;0;776119540;47001469;729118071;
5954;900222662;2019-12-31;2019;MILES;8076886;7383006;693880;97974;0;595906;5819;11069;0;689081;1268099;236529;1031570;
5955;900222662;2019-12-31;2018;MILES;3072401;2903362;169039;47361;0;121678;10709;203638;218;331423;238972;92725;146247;
5956;900678425;2019-12-31;2019;MILES;211671;0;211671;167699;0;43972;0;16600;58871;0;606714;22431;584283;
5957;900678425;2019-12-31;2018;MILES;318029;0;318029;194796;0;123233;5;16155;38066;24532;671779;44885;626894;
5958;830116134;2019-12-31;2019;MILES;255772258;202452220;53320038;20647255;0;32672783;17191577;38003728;0;29179653;6657131;4642474;2014657;
5959;830116134;2019-12-31;2018;MILES;196501008;168619298;27881710;15159602;0;12722108;18442648;16737115;0;13229848;-9227807;-6117698;-3110109;
5960;860509719;2019-12-31;2019;MILES;2196472;0;2196472;1286421;0;910051;9311;33117;110305;2973710;10073964;1070322;9003642;
5961;860509719;2019-12-31;2018;MILES;2040373;0;2040373;1049310;0;991063;13539;21650;26178;60006;5509611;72333;5437278;
5962;890301602;2019-12-31;2019;MILES;76314761;48064999;28249762;14981635;6913484;6354643;5372096;0;446618;0;1555188;-1962952;3518140;
5963;890301602;2019-12-31;2018;MILES;70582869;47825846;22757023;15861344;7894401;-998722;7987332;0;0;381185;-8584960;-3363195;-5221765;
5964;860053523;2019-12-31;2019;MILES;16314418;968589;15345829;1777004;12691618;877207;225951;81552;71232;124389;829187;362486;466701;
5965;860053523;2019-12-31;2018;MILES;17442049;2443315;14998734;1662151;13374603;-38020;156342;267338;76967;25500;-310140;58228;-368368;
5966;900170693;2019-12-31;2019;MILES;34967395;0;34967395;1693559;0;33273836;0;111950;0;0;33161886;3961767;29200119;
5967;900170693;2019-12-31;2018;MILES;3485679;0;3485679;1217626;0;2268053;0;119805;0;0;2148248;557686;1590562;
5968;860001317;2019-12-31;2019;MILES;18731191;4449327;14281864;48433111;0;-34151247;10694272;80;173117;1561486;-63042570;-8428466;-54614104;
5969;860001317;2019-12-31;2018;MILES;47881839;13165993;34715846;60633114;0;-25917268;18230686;205;647714;9977445;-50710713;3963519;-54674232;
5970;891800111;2019-12-31;2019;MILES;1030775292;955363615;75411677;27954120;11111516;36346041;30572317;68320931;2756254;0;-48308511;0;-109152110;
5971;891800111;2019-12-31;2018;MILES;973211709;869436194;103775515;23803687;8754471;71217357;37049307;7164636;3135015;0;40139632;0;35984274;
5972;800127132;2019-12-31;2019;MILES;103948104;67095138;36852966;6281029;12365830;18206107;4950653;1863765;4887256;506335;16785280;6229314;10555966;
5973;800127132;2019-12-31;2018;MILES;90077135;58984294;31092841;6401678;10937222;13753941;4015990;3219928;5085224;433775;12037022;4835716;7201306;
5974;830112404;2019-12-31;2019;MILES;52942;0;52942;217663;0;-164721;2178;59066;36680;1006;5377;193573;-188196;
5975;830112404;2019-12-31;2018;MILES;11546;0;11546;171451;0;-159905;2011;72155;34704;393884;766882;193689;573193;
5976;900522845;2019-12-31;2019;MILES;2763577;0;2763577;1369479;0;1394098;3568661;21860;351555;386084;5446412;555331;4891081;
5977;900522845;2019-12-31;2018;MILES;2340726;0;2340726;2001051;0;339675;5582618;55377;315428;51097;5176830;-1217341;6394171;
5978;900462511;2019-12-31;2019;MILES;527331409;191070853;336260556;130890736;179103766;26266054;31560451;4360282;3602623;34582213;30483723;35173582;-4689859;
5979;900462511;2019-12-31;2018;MILES;467887783;189545849;278341934;101439751;143010603;33891580;37555369;3418970;1322489;40439539;33503613;10559624;22943989;
5980;800229035;2019-12-31;2019;MILES;665803012;508312643;157490369;20501746;39421157;97567466;52828857;3806568;0;1942084;42874125;18273667;24600458;
5981;800229035;2019-12-31;2018;MILES;562329431;437055151;125274280;20902841;35322635;69048804;48238080;39007973;0;1562547;-16634702;-7091391;-9543311;
5982;800141506;2019-12-31;2019;MILES;546301087;513126344;33174743;12970804;5937157;14266782;30262831;157185;17165313;16832345;17844424;3233224;14611200;
5983;800141506;2019-12-31;2018;MILES;442868138;422456576;20411562;9698761;4208960;6503841;22843834;22933;13720098;10990350;8347522;-419681;8767203;
5984;901084632;2019-12-31;2019;MILES;427500;0;427500;265602;0;161898;280333;30454;124963;0;-4859425;134990;-4994415;
5985;901084632;2019-12-31;2018;MILES;0;0;0;51538;0;-51538;59406;0;101116;0;-8186955;7647;-8194602;
5986;860048112;2019-12-31;2019;MILES;67016458;57023410;9993048;6094970;899714;2998364;2087114;140483;153832;0;924599;516550;408049;
5987;860048112;2019-12-31;2018;MILES;70645377;58453642;12191735;8313014;1372689;2506032;2018515;233398;91838;0;976957;330291;646666;
5988;811011909;2019-12-31;2019;MILES;58286765;37352180;20934585;5198188;11092323;4644074;5247553;410714;1529788;1883638;2399233;777052;1622181;
5989;811011909;2019-12-31;2018;MILES;47979936;30333038;17646898;3942057;9352021;4352820;4780790;126652;206278;1379829;1031485;127407;904078;
5990;860042603;2019-12-31;2019;MILES;25208386;31018775;-5810389;4686468;0;-10496857;748541;12506874;458840;1890647;-20171619;117971;-20289590;
5991;860042603;2019-12-31;2018;MILES;33783459;32102268;1681191;5864486;0;-4183295;5051284;3465454;2622121;3367264;-6710648;26786;-6737434;
5992;817001528;2019-12-31;2019;MILES;120951344;104050282;16901062;6340590;5147529;5412943;926035;4252555;24065;2781397;5269789;736922;4532867;
5993;817001528;2019-12-31;2018;MILES;119659058;96124082;23534976;6589414;5375620;11569942;895267;756191;70475;2037650;13762230;2657953;11104277;
5994;811027317;2019-12-31;2019;MILES;73462832;60983424;12479408;2343349;8406860;1729199;4003089;317986;3988252;759235;3225212;808185;2417027;
5995;811027317;2019-12-31;2018;MILES;81816746;69136263;12680483;2147695;7646736;2886052;4112781;947335;1281615;926069;23945;443549;-419604;
5996;901015072;2019-12-31;2019;MILES;0;0;0;18896;0;-18896;116818;0;0;0;10270125;35;10270090;
5997;901015072;2019-12-31;2018;MILES;0;0;0;20854;0;-20854;266307;117460;0;0;5374802;120;5374682;
5998;800027374;2019-12-31;2019;MILES;77645381;52438859;25206522;7140944;13868270;4197308;4897818;455549;1762030;2756505;5077787;1863881;3213906;
5999;800027374;2019-12-31;2018;MILES;72811424;49135562;23675862;8374236;14321110;980516;4189077;375656;1112868;2716206;1682404;1382154;300250;
6000;860002837;2019-12-31;2019;MILES;67137524;46827990;20309534;16646805;1600679;2062050;4561245;818086;965110;1404411;-947760;-1103877;156117;
6001;860002837;2019-12-31;2018;MILES;88455161;76809163;11645998;10892257;368609;385132;4481945;598796;830958;1787319;-1213753;-640369;-573384;
6002;860031699;2019-12-31;2019;MILES;31295388;22585062;8710326;2376718;4090468;2243140;147528;0;0;0;1999726;-3102251;5123859;
6003;860031699;2019-12-31;2018;MILES;37962501;28614473;9348028;2172988;4424169;2750871;933987;0;0;0;1396575;-191661;1621826;
6004;890903295;2019-12-31;2019;MILES;235883611;220174396;15709215;19442789;0;-3733574;10628084;0;2111037;0;34954118;2721780;32232338;
6005;890903295;2019-12-31;2018;MILES;229890842;201696933;28193909;20379598;0;7814311;3859117;2820258;1322206;0;22169053;3957958;18211095;
6006;900386417;2019-12-31;2019;MILES;244603780;127864600;116739180;10723466;21767462;84248252;3289146;837407;1143462;9193769;90458930;30876002;59582928;
6007;900386417;2019-12-31;2018;MILES;152471237;86950850;65520387;12906703;12915673;39698011;1725744;1817490;1958049;3378635;41491461;17585883;23905578;
6008;800249805;2019-12-31;2019;MILES;5718085;2790125;2927960;1335783;1163434;428743;217427;377760;0;387330;278403;118369;160034;
6009;800249805;2019-12-31;2018;MILES;5682678;3093931;2588747;1113831;1342071;132845;54856;270944;0;417059;257208;98143;159065;
6010;830057706;2019-12-31;2019;MILES;143165807;111225344;31940463;7252964;14708763;9978736;0;0;0;0;3548222;1908905;1639317;
6011;830057706;2019-12-31;2018;MILES;137303565;101207273;36096292;5783196;22688226;7624870;0;0;0;0;841636;3582614;-2740978;
6012;900348144;2019-12-31;2019;MILES;0;0;0;1366644;0;-1366644;309403;3664630;0;6342601;1001924;39;1001885;
6013;900348144;2019-12-31;2018;MILES;0;0;0;71007;0;-71007;154149;2217935;0;563895;-1879196;12222;-1891418;
6014;800249704;2019-12-31;2019;MILES;230359859;203104551;27255308;7837654;31672489;-12254835;3305871;3572729;0;6715962;-11642852;541435;-12184287;
6015;800249704;2019-12-31;2018;MILES;238892427;206931036;31961391;5224764;32760834;-6024207;3835935;3483085;0;2866558;-10476669;48140;-10524809;
6016;900010692;2019-12-31;2019;MILES;148159779;129882366;18277413;4029176;0;14248237;0;25861737;756994;21574760;10718254;3731820;6986434;
6017;900010692;2019-12-31;2018;MILES;113178668;102156896;11021772;3806589;0;7215183;0;20888090;488593;10674325;-2509989;-558205;-1951784;
6018;805004835;2019-12-31;2019;MILES;20859252;11586113;9273139;6019142;0;3253997;6390451;2083323;6545887;0;-9504296;-605469;-8898827;
6019;805004835;2019-12-31;2018;MILES;24932030;12669625;12262405;8060138;0;4202267;3288622;3291;2976558;3712;-2342294;671554;-3013848;
6020;901009415;2019-12-31;2019;MILES;0;0;0;25209;0;-25209;0;1593943;0;222;-1618930;69253;-1688183;
6021;901009415;2019-12-31;2018;MILES;5959519;0;5959519;37548;0;5921971;0;36;0;529;5922464;92179;5830285;
6022;800013834;2019-12-31;2019;MILES;196349590;86754022;109595568;14314343;60103904;35177321;19502595;0;0;6295694;12397179;5413336;6983843;
6023;800013834;2019-12-31;2018;MILES;193601551;81463948;112137603;13425605;61086725;37625273;18653692;0;0;3274759;22718215;4363820;18354395;
6024;901196014;2019-12-31;2019;MILES;0;0;0;3088209;0;-3088209;0;0;75730;3681906;313429817;40349655;273080162;
6025;901196014;2019-12-31;2018;MILES;0;0;0;6360067;0;-6360067;0;0;2977;0;143593177;52637943;90955234;
6026;860008278;2019-12-31;2019;MILES;953;0;953;25677;0;-24724;63;16839;0;0;-41626;-8305;-33321;
6027;860008278;2019-12-31;2018;MILES;559664;0;559664;22060;0;537604;30;0;0;2;537576;21146;516430;
6028;819004712;2019-12-31;2019;MILES;561657572;536137051;25520521;16974177;0;8546344;23464246;11312232;2596510;7190726;-16442898;1467414;-17910312;
6029;819004712;2019-12-31;2018;MILES;394661909;362084378;32577531;15779530;0;16798001;36439378;6086806;9644590;5592083;-7927812;8539222;-16467034;
6030;860008414;2019-12-31;2019;MILES;6726;0;6726;20699;0;-13973;55;15936;0;0;-29962;1873;-31835;
6031;860008414;2019-12-31;2018;MILES;511093;0;511093;25298;0;485795;48;0;0;0;485748;32020;453728;
6032;860035996;2019-12-31;2019;MILES;60702972;42350706;18352266;8777188;0;9575078;2583899;0;1739711;0;8730890;3029102;5701788;
6033;860035996;2019-12-31;2018;MILES;49969606;35392193;14577413;7045044;0;7532369;11697973;0;2199773;0;-1965831;4242850;-6208681;
6034;800118334;2019-12-31;2019;MILES;125331440;60798678;64532762;14284000;43110517;7138245;1522249;1915093;678494;528003;4751990;505048;4246942;
6035;800118334;2019-12-31;2018;MILES;114983567;56187406;58796161;13354029;37003212;8438920;1901194;3520137;1043375;607705;4503811;1536950;2966861;
6036;860013652;2019-12-31;2019;MILES;95434216;0;95434216;2142458;0;93291758;13513;123594;0;0;44124777;1993214;42131563;
6037;860013652;2019-12-31;2018;MILES;81541477;0;81541477;2203523;0;79337954;220791;1674;0;213;47718574;137534;47581040;
6038;860002304;2019-12-31;2019;MILES;2702439057;2468150004;234289053;70429809;116884520;46974724;12358835;434353;1507676;78065074;154582015;18585954;135996061;
6039;860002304;2019-12-31;2018;MILES;2490236912;2246522330;243714582;104641055;131233734;7839793;19281167;2993902;1653400;52254847;80188061;-1560914;81748975;
6040;890900122;2019-12-31;2019;MILES;583;0;583;20603;0;-20020;94;7932;0;2;-28044;-749;-27295;
6041;890900122;2019-12-31;2018;MILES;495291;0;495291;21321;0;473970;44;0;0;1;473927;14747;459180;
6042;900377163;2019-12-31;2019;MILES;313499838;195490076;118009762;28310322;0;89699440;133857313;0;1667034;0;-43063279;2075232;-45138511;
6043;900377163;2019-12-31;2018;MILES;281893911;190749776;91144135;25735368;0;65408767;89777201;0;5520947;0;-19435197;4502628;-23937825;
6044;860005331;2019-12-31;2019;MILES;5364176;4750407;613769;33590;19323;560856;141820;408931;44326;40053;118332;-64590;182922;
6045;860005331;2019-12-31;2018;MILES;3633238;4554327;-921089;37173;23717;-981979;232154;104478;28988;93357;-1196266;60267;-1256533;
6046;890910354;2019-12-31;2019;MILES;117083995;72548262;44535733;15101915;6914022;22519796;5940875;1121206;3719952;2388489;21566156;6802357;14763799;
6047;890910354;2019-12-31;2018;MILES;113345782;68863019;44482763;14186038;10745851;19550874;6072697;1011001;2728188;1954376;17149740;7544757;9604983;
6048;800070993;2019-12-31;2019;MILES;36354175;28810902;7543273;3558383;1493251;2491639;2202762;106681;148953;0;579700;-42409;622109;
6049;800070993;2019-12-31;2018;MILES;35254481;27038674;8215807;3116638;1706697;3392472;2390908;44486;32365;1226845;1460525;59;1460466;
6050;860524513;2019-12-31;2019;MILES;55111965;40204041;14907924;11535870;0;3372054;2869345;2941026;194856;1096971;-1189348;2435961;-3625309;
6051;860524513;2019-12-31;2018;MILES;42944164;30892889;12051275;11522519;0;528756;2256105;482806;0;0;-2264135;186000;-2450135;
6052;860028601;2019-12-31;2019;MILES;214658311;85849217;128809094;47422200;0;81386894;0;0;0;18784555;68321508;22434218;45887290;
6053;860028601;2019-12-31;2018;MILES;192093735;65986234;126107501;37434532;0;88672969;0;0;0;29670577;60066973;23978403;36088570;
6054;860526606;2019-12-31;2019;MILES;52051583;44448272;7603311;1552036;395230;5656045;1575125;86620;423945;110465;4528710;1507042;3021668;
6055;860526606;2019-12-31;2018;MILES;39751018;33490501;6260517;2194982;345828;3719707;1403888;36730;20152;46164;2345405;829288;1516117;
6056;900966105;2019-12-31;2019;MILES;29350292;24410062;4940230;752063;3092540;1095627;551174;579257;84268;26634;76098;604309;-528211;
6057;900966105;2019-12-31;2018;MILES;29475274;25899693;3575581;1645942;2387431;-457792;2275143;0;108984;112168;-2511657;-782380;-1729277;
6058;900553004;2019-12-31;2019;MILES;26405635;27362937;-957302;4046355;0;-5003657;9920984;2021334;0;22550905;3301053;3117236;183817;
6059;900553004;2019-12-31;2018;MILES;31909128;27384196;4524932;3997159;193354;334419;5724501;4456300;0;14726300;1889256;1224234;665022;
6060;830501113;2019-12-31;2019;MILES;0;0;0;2684096;0;-2684096;0;121800;1382337;13374;-386034;0;-386034;
6061;830501113;2019-12-31;2018;MILES;960000;0;960000;1387255;0;-427255;0;4460;362805;176374;724899;73123;651776;
6062;901193512;2019-12-31;2019;MILES;0;0;0;1713;0;-1713;0;0;0;0;-1713;0;-1713;
6063;901193512;2019-12-31;2018;MILES;0;0;0;0;0;0;0;0;0;0;0;0;0;ERR valores en cero
6064;900411117;2019-12-31;2019;MILES;0;0;0;1160020;0;-1160020;205704;1037808;331205;767282;-1305045;-32125;-1272920;
6065;900411117;2019-12-31;2018;MILES;0;0;0;37354;0;-37354;19640;0;0;785;-56209;-6814;-49395;
6066;860001307;2019-12-31;2019;MILES;1362837720;1133478468;229359252;25294325;186311229;17753698;55729450;2286373;36690474;39504665;35933014;12027951;23905063;
6067;860001307;2019-12-31;2018;MILES;1383944348;1094937680;289006668;25261519;195157333;68587816;83280285;2786241;55720993;34051115;72293398;29161311;43132087;
6068;900418536;2019-12-31;2019;MILES;1165742;1134433;31309;1651356;496394;-2116441;733205;0;2069;248986;452043;156210;295833;
6069;900418536;2019-12-31;2018;MILES;981900;1456758;-474858;1712627;462330;-2649815;614985;92979;2847;236677;268622;19171;249451;
6070;800142811;2019-12-31;2019;MILES;30785270;23125692;7659578;2699524;3525751;1434303;182915;1962424;128988;461212;572830;839440;-266610;
6071;800142811;2019-12-31;2018;MILES;29619955;21527406;8092549;2747816;3399140;1945593;202642;814737;125555;254747;1921567;994591;926976;
6072;800146616;2019-12-31;2019;MILES;44207511;0;44207511;5629593;0;38577918;4611670;25088908;2805851;93656;47925592;2611968;45313624;
6073;800146616;2019-12-31;2018;MILES;30637920;0;30637920;4741535;0;25896385;4870577;20966487;1056761;2158271;18412763;1074300;17338463;
6074;800150267;2019-12-31;2019;MILES;30166224;20014185;10152039;9853198;0;298841;8547768;380025;6281774;2992198;645020;70213;574807;
6075;800150267;2019-12-31;2018;MILES;33931350;22255435;11675915;9593143;0;2082772;3942818;196348;2232623;1309148;1485377;292394;1192983;
6076;860061173;2019-12-31;2019;MILES;11345103;0;11345103;1664748;813468;8866887;0;3141447;0;420235;6301697;98823;6202874;
6077;860061173;2019-12-31;2018;MILES;10093999;0;10093999;1579777;2385838;6128384;0;1500532;0;202383;4707124;371689;4335435;
6078;800047031;2019-12-31;2019;MILES;235565755;169712949;65852806;8963477;19080087;37809242;3317006;590604;3354818;492114;70202165;13709163;56493002;
6079;800047031;2019-12-31;2018;MILES;251573235;175661223;75912012;8600522;19313471;47998019;6565054;1333542;5144114;13213847;85540195;20187363;65352832;
6080;900082107;2019-12-31;2019;MILES;37186376;29708419;7477957;5113952;0;2364005;1613445;0;0;0;750560;346576;403984;
6081;900082107;2019-12-31;2018;MILES;41671447;33656059;8015388;4007226;0;4008162;1475717;0;0;0;2532445;375667;2156778;
6082;813000008;2019-12-31;2019;MILES;50715419;34954009;15761410;3818022;1062519;10880869;3141390;621222;116686;177103;7484547;3615707;3868840;
6083;813000008;2019-12-31;2018;MILES;32952511;23015805;9936706;2757062;599893;6579751;2715290;993864;87852;50874;2968591;-793064;3761655;
6084;891300238;2019-12-31;2019;MILES;759649698;550425570;209224128;30826404;43265493;135132231;15861687;11775578;2540424;3272580;113865652;36721343;77144309;
6085;891300238;2019-12-31;2018;MILES;696445376;503261905;193183471;28738628;39308846;125135997;16829088;8680756;3845143;3526466;102100157;35963573;66136584;
6086;890102110;2019-12-31;2019;MILES;486111238;421943910;64167328;40554939;10301428;13310961;20436716;0;6926123;0;-1902438;604672;-2507110;
6087;890102110;2019-12-31;2018;MILES;450782083;397251243;53530840;52943936;14527872;-13940968;23768101;0;3329149;0;-34379920;-371704;-34008216;
6088;860005080;2019-12-31;2019;MILES;132653260;98593101;34060159;20266849;5494354;8298956;5305208;0;0;0;3909519;2013180;1896339;
6089;860005080;2019-12-31;2018;MILES;134581972;100899577;33682395;18743855;5317695;9620845;5419618;0;0;0;5542735;2811438;2731297;
6090;900148608;2019-12-31;2019;MILES;407884;153402;254482;188049;0;66433;3306;72528;114449;0;439963;120950;319013;
6091;900148608;2019-12-31;2018;MILES;701312;414557;286755;207001;0;79754;9924;134448;62994;0;163986;56775;107211;
6092;890204814;2019-12-31;2019;MILES;278893631;248306754;30586877;5387033;5303034;19896810;4541522;0;348591;161687;14628234;4620661;10007573;
6093;890204814;2019-12-31;2018;MILES;152010084;133950909;18059175;3524052;3415720;11119403;3399865;0;18823;461534;8253977;3005994;5247983;
6094;891300237;2019-12-31;2019;MILES;860622885;672128170;188494715;53468305;74666199;60360211;45995084;10697991;2202966;2919642;37071761;-5791326;42863087;
6095;891300237;2019-12-31;2018;MILES;865370124;681518745;183851379;51210512;79112071;53528796;51807381;11084602;24199674;4581967;55915157;13172605;42742552;
6096;890906413;2019-12-31;2019;MILES;260632112;234232884;26399228;10402580;4403604;11593044;6060247;466187;14885045;6394723;118696953;8815945;109881008;
6097;890906413;2019-12-31;2018;MILES;459666519;408298613;51367906;8999059;4899596;37469251;6805279;1301353;12638096;5328053;88583460;11451019;77132441;
6098;891300959;2019-12-31;2019;MILES;313006090;248984108;64021982;13328188;44118215;6575579;8112655;1174496;1493738;503440;-2586605;1174276;-3760881;
6099;891300959;2019-12-31;2018;MILES;281336205;217033260;64302945;14533040;37876585;11893320;8250170;1000701;417910;994486;1474962;-53815;1528777;
6100;891104736;2019-12-31;2019;MILES;53556749;40455695;13101054;11326071;3278664;-1503681;120438;1415166;7515;4206963;1175193;625120;550073;
6101;891104736;2019-12-31;2018;MILES;45550833;35550128;10000705;9192844;0;807861;133281;433423;17092;860432;1118681;489946;628735;
6102;900318567;2019-12-31;2019;MILES;48653054;45539029;3114025;5995054;250928;-3131957;1056070;0;0;0;-4445781;903806;-5349587;
6103;900318567;2019-12-31;2018;MILES;35955801;30077191;5878610;6992508;182605;-1296503;2699260;0;0;0;-3844852;-648876;-3195976;
6104;860509514;2019-12-31;2019;MILES;662244569;533924053;128320516;12965597;0;115354919;9656608;10262557;7544491;12700154;32804468;13890307;18914161;
6105;860509514;2019-12-31;2018;MILES;598468758;474880687;123588071;14344064;0;109244007;10491148;10788675;5537787;14033190;26194986;10992303;15202683;
6106;900054711;2019-12-31;2019;MILES;100167269;48259813;51907456;5708305;39991731;6207420;20803482;5828832;1764120;0;-18660774;-661821;-19822661;
6107;900054711;2019-12-31;2018;MILES;166907747;83405867;83501880;7235315;48352215;27914350;15240775;5193143;517371;0;7997803;4267063;5323017;
6108;860041813;2019-12-31;2019;MILES;43417554;27258683;16158871;5225290;8865797;2067784;3441277;0;234973;777517;4680218;1021878;3658340;
6109;860041813;2019-12-31;2018;MILES;39319804;24796879;14522925;5092190;7960822;1469913;3203566;0;390368;438442;3793157;791208;3001949;
6110;860045623;2019-12-31;2019;MILES;37289600;31168643;6120957;3786792;0;2334165;2410005;493193;488089;1355263;1370349;511422;858927;
6111;860045623;2019-12-31;2018;MILES;48050767;41892559;6158208;3718174;0;2440034;1467233;333803;334283;233624;1509025;1884018;-374993;
6112;901253015;2019-12-31;2019;MILES;132240297;92514905;39725392;21687291;0;18038101;191654;3650445;9294463;3654249;23841868;8262428;15579440;
6113;901253015;2019-12-31;2018;MILES;1;0;1;0;0;1;0;0;0;0;1;0;1;
6114;860038955;2019-12-31;2019;MILES;93743559;72268347;21475212;5965254;3725406;11784552;6707233;99525;4028855;67304;9073953;3547058;5526895;
6115;860038955;2019-12-31;2018;MILES;53276464;43130747;10145717;3779185;3839257;2527275;3326018;497279;3479743;930293;3114014;733333;2380681;
6116;800144340;2019-12-31;2019;MILES;2462463;0;2462463;1039454;0;1423009;13479;0;0;750204;2159734;3936093;-1776359;
6117;800144340;2019-12-31;2018;MILES;1580185;0;1580185;1170111;0;410074;133917;0;0;432066;708223;115405;592818;
6118;800212840;2019-12-31;2019;MILES;300154924;144253433;155901491;57357145;78317444;20226902;6815362;0;0;4107803;20183236;5629304;14553932;
6119;800212840;2019-12-31;2018;MILES;288738722;131627333;157111389;56552365;86514540;14044484;12451752;0;0;5106239;11987499;6967172;5020327;
6120;890106814;2019-12-31;2019;MILES;266117019;220908640;45208379;3599238;13648423;27960718;4933453;82496;137989;836661;23919419;7154218;16765201;
6121;890106814;2019-12-31;2018;MILES;213197890;175414163;37783727;3501590;12283899;21998238;3662693;550443;150174;0;17935276;6084119;11851157;
6122;860524337;2019-12-31;2019;MILES;12429499;6213952;6215547;4283455;0;1932092;1169165;1400873;80724;1702270;5550120;234644;5315476;
6123;860524337;2019-12-31;2018;MILES;12648632;6483571;6165061;5217154;0;947907;1372544;15475;2893;1554555;3162030;730426;2431604;
6124;830058056;2019-12-31;2019;MILES;57396449;29269046;28127403;18129898;0;9997505;1103333;762128;238617;185163;11599018;2523668;9075350;
6125;830058056;2019-12-31;2018;MILES;55113982;27868531;27245451;18070960;0;9174491;1152095;931924;194251;181385;10802598;3308552;7494046;
6126;900248016;2019-12-31;2019;MILES;305100;128552;176548;2916766;0;-2740218;113440;43606;2765;33508;-2980298;-106252;-2874046;
6127;900248016;2019-12-31;2018;MILES;1703660;508411;1195249;1254791;0;-59542;444121;127751;1005;64762;-691153;0;-691153;
6128;890307989;2019-12-31;2019;MILES;0;0;0;102182;0;-102182;0;0;0;0;20787970;37876;20750094;
6129;890307989;2019-12-31;2018;MILES;0;0;0;257550;0;-257550;0;0;0;0;25106298;339018;24767280;
6130;830071114;2019-12-31;2019;MILES;63018827;59172661;3846166;5627735;0;-1781569;1793145;397134;48524;877702;-2790594;-29229;-2761365;
6131;830071114;2019-12-31;2018;MILES;56197698;48333687;7864011;5781385;0;2082626;1388635;332575;203065;2117731;3342896;68272;3274624;
6132;860002302;2019-12-31;2019;MILES;215665844;168210648;47455196;19162666;28198451;94079;2146176;3119427;612747;1509463;-2215350;-915808;-1299542;
6133;860002302;2019-12-31;2018;MILES;217219979;171816223;45403756;19067426;23835389;2500941;1834682;1589981;2036766;3231436;4651559;5760609;-14571266;
6134;830078515;2019-12-31;2019;MILES;260765924;206514616;54251308;31558374;20752333;1940601;98975344;9791738;76077201;43875084;12009973;9513941;2496032;
6135;830078515;2019-12-31;2018;MILES;190013482;173217064;16796418;18635697;16501059;-18340338;55318365;3569992;44798987;30733033;-3836232;2234565;-6070797;
6136;891100445;2019-12-31;2019;MILES;1250977304;1033986833;216990471;27821009;116525853;72643609;22171807;1398856;24101240;5952839;98675220;31460625;67214595;
6137;891100445;2019-12-31;2018;MILES;1086592049;937696946;148895103;25614064;111910790;11370249;21514372;1183315;18384610;5437439;31672118;3385025;28287093;
6138;890300918;2019-12-31;2019;MILES;18639799;10533859;8105940;2563351;3207639;2334950;1948536;49314;329175;0;726924;261035;465889;
6139;890300918;2019-12-31;2018;MILES;18844792;10912166;7932626;2772708;2601344;2558574;1998654;50903;450418;0;1438134;262016;1176118;
6140;860029415;2019-12-31;2019;MILES;34675661;21436916;13238745;4712566;5812520;2713659;992584;0;258691;0;3944532;601367;3343165;
6141;860029415;2019-12-31;2018;MILES;32153773;21922088;10231685;3886987;5892097;452601;1410822;0;16523;0;-711670;57205;-768875;
6142;900283417;2019-12-31;2019;MILES;0;0;0;30940;0;-30940;0;0;51212;0;4762268;12213;4750055;
6143;900283417;2019-12-31;2018;MILES;0;0;0;0;0;0;13949;0;62291;0;3992625;49779;3942846;
6144;900422614;2019-12-31;2019;MILES;223709201;0;223709201;144406382;11799627;67503192;20059945;54828899;0;4278122;-1694352;28632646;-30326998;
6145;900422614;2019-12-31;2018;MILES;204008132;0;204008132;113848101;12288895;77871136;28102705;43088815;0;4554180;11233796;24899058;-13665262;
6146;890900652;2019-12-31;2019;MILES;244633645;166969996;77663649;58584692;0;19078957;3207475;2217598;1586117;0;19271591;4520444;14751147;
6147;890900652;2019-12-31;2018;MILES;222178826;144051865;78126961;53728864;0;24398097;2158155;2020479;2833712;0;23428541;8633385;14795156;
6148;890200463;2019-12-31;2019;MILES;593246513;289097571;304148942;18544660;256023203;29581079;1403710;199626;40858;1719521;34940633;9129805;25810828;
6149;890200463;2019-12-31;2018;MILES;494769414;251911485;242857929;17408392;198237220;27212317;961596;2596909;69128;1627219;24038670;5915015;18123655;
6150;860000018;2019-12-31;2019;MILES;286227846;118066227;168161619;37002741;107964643;23194235;0;43884572;0;27458698;6768361;3633139;3135222;
6151;860000018;2019-12-31;2018;MILES;253350121;114838755;138511366;39371416;94393732;4746218;0;20416037;0;20235883;4566064;1856933;2709131;
6152;900337718;2019-12-31;2019;MILES;4342;0;4342;82854;0;-78512;0;11367;0;125056;35177;9693;25484;
6153;900337718;2019-12-31;2018;MILES;8257;0;8257;88097;0;-79840;0;457;0;320245;239948;2122;237826;
6154;800013638;2019-12-31;2019;MILES;39578079;28913331;10664748;2862148;3108935;4693665;5561479;47911;6074887;612189;5783536;1939531;3844005;
6155;800013638;2019-12-31;2018;MILES;37811444;28147057;9664387;2718928;1784835;5160624;2487338;93151;3450337;183065;6212120;3001396;3210724;
6156;890106527;2019-12-31;2019;MILES;810721031;410243045;400477986;132450804;144856825;123170357;70293859;102172943;0;90686852;41390407;5334645;36055762;
6157;890106527;2019-12-31;2018;MILES;728961607;351255770;377705837;128686713;142274583;106744541;60166496;196169677;0;171474568;21882936;22002661;-119725;
6158;891300120;2019-12-31;2019;MILES;8585477;5730360;2855117;1897264;442416;515437;277145;813205;364552;480821;270460;293324;-22864;
6159;891300120;2019-12-31;2018;MILES;9341285;5789283;3552002;1887692;460124;1204186;139726;547680;263416;200414;980610;375895;604715;
6160;890903035;2019-12-31;2019;MILES;209880464;177895641;31984823;11189580;0;20795243;19766643;17630320;15176215;30753599;29328094;2618266;26709828;
6161;890903035;2019-12-31;2018;MILES;191589934;166289678;25300256;9852167;0;15448089;0;33686251;0;33648537;15410375;-2921040;18331415;
6162;830513773;2019-12-31;2019;MILES;135615979;109949788;25666191;15784958;0;9881233;4792603;0;4533989;0;9688951;-1219382;10908333;
6163;830513773;2019-12-31;2018;MILES;123206124;95105432;28100692;18913050;0;9187642;4303541;0;3082665;0;7920441;4624503;3295938;
6164;811041746;2019-12-31;2019;MILES;69503429;42174538;27328891;1415019;14089284;11824588;2553308;482168;0;1807479;10596591;3338803;7257788;
6165;811041746;2019-12-31;2018;MILES;69288263;41345048;27943215;2101949;13603814;12237452;3169316;465067;0;1879836;10482905;4124497;6358408;
6166;900215262;2019-12-31;2019;MILES;26861586;18960468;7901118;5535144;1383117;982857;3144624;233039;742776;6515263;4871415;686034;4185381;
6167;900215262;2019-12-31;2018;MILES;23333232;15919030;7414202;3946461;2139925;1327816;3169458;154737;874750;8679790;7356229;1058783;6297446;
6168;860026753;2019-12-31;2019;MILES;655371111;564228995;91142116;34329275;23060249;33752592;29819907;35239322;31910808;9431705;10035876;4771494;5264382;
6169;860026753;2019-12-31;2018;MILES;646870713;582450063;64420650;39828804;23283026;1308820;53654662;30350399;30377280;19459808;-33003069;-13692744;-19310325;
6170;901112319;2019-12-31;2019;MILES;12522590;5404171;7118419;5226431;0;1891988;1058;0;6037825;0;6338178;2988321;3349857;
6171;901112319;2019-12-31;2018;MILES;209386;6400293;-6190907;203250;0;-6394157;92877;0;4282174;0;-3429280;-157661;-3271619;
6172;860005224;2019-12-31;2019;MILES;4535456053;1425188717;3110267336;960751406;292879111;1856636819;176469207;0;12468765;0;2932289941;577567929;2354722012;
6173;860005224;2019-12-31;2018;MILES;4582163579;1150638560;3431525019;1294147189;364950061;1772427769;345781186;0;38550604;0;2830926924;385523547;2445403377;
6174;890906197;2019-12-31;2019;MILES;45118724;34634928;10483796;4086893;2435617;3961286;0;3547081;0;27489;441694;190000;251694;
6175;890906197;2019-12-31;2018;MILES;40214643;30658764;9555879;3750728;2181148;3624003;0;3294331;0;80112;409784;277641;132143;
6176;900313945;2019-12-31;2019;MILES;107674400;102765459;4908941;2556285;821764;1530892;2125519;204390;1081358;1308111;1646105;614501;1031604;
6177;900313945;2019-12-31;2018;MILES;86247399;81121176;5126223;2141416;439411;2545396;2289732;120630;120002;374734;629770;369229;260541;
6178;800136561;2019-12-31;2019;MILES;207121305;158745022;48376283;20577457;0;27798826;1158532;216516;713997;1818896;28618334;1638597;26979737;
6179;800136561;2019-12-31;2018;MILES;164501716;126394611;38107105;19475701;0;18631404;975298;185787;1277029;1686018;20441867;2052043;18389824;
6180;830034723;2019-12-31;2019;MILES;572545766;0;572545766;25504424;0;547041342;0;193796964;0;11905338;365149716;18795781;346353935;
6181;830034723;2019-12-31;2018;MILES;262008311;0;262008311;24711097;0;237297214;0;50497110;0;3022610;189822714;18342550;171480164;
6182;830501720;2019-12-31;2019;MILES;0;0;0;2537105;0;-2537105;22004;100543;2573061;306072;347781;4880;342901;
6183;830501720;2019-12-31;2018;MILES;0;0;0;2488331;0;-2488331;0;20511;2342448;346928;285601;8668;276933;
6184;830059718;2019-12-31;2019;MILES;127363340;80373696;46989644;14806730;2414434;29768480;3274774;892271;924977;516584;27042996;8920289;18122707;
6185;830059718;2019-12-31;2018;MILES;102937789;69879828;33057961;10683348;2252700;20121913;2841627;867052;562390;483933;17459557;4417564;13041993;
6186;860061284;2019-12-31;2019;MILES;30453773;33347;30420426;28105343;0;2315083;6191861;1309434;239070;6141275;1194133;713112;481021;
6187;860061284;2019-12-31;2018;MILES;28552939;454707;28098232;19264570;0;8833662;8774773;1376503;241845;10780725;9704956;3895980;5808976;
6188;860028238;2019-12-31;2019;MILES;84136159;37665935;46470224;11599325;18783565;16087334;1077585;1407754;2134529;532950;17307847;5470453;11837394;
6189;860028238;2019-12-31;2018;MILES;79701833;34988724;44713109;10780362;16423967;17508780;87690;2508844;1695434;341470;18908064;5404171;13503893;
6190;860515523;2019-12-31;2019;MILES;24061460;18292631;5768829;5250297;3610;514922;725356;119775;17131;1172470;859392;327316;532076;
6191;860515523;2019-12-31;2018;MILES;15725506;7116926;8608580;7012738;76799;1519043;469532;344737;47791;60496;816540;321211;495329;
6192;860078622;2019-12-31;2019;MILES;68563741;60029452;8534289;3256844;1474566;3802879;7115469;2437800;389986;772489;-3569517;105721;-3675238;
6193;860078622;2019-12-31;2018;MILES;54014752;46953574;7061178;3804625;1026183;2230370;3587327;1163559;546024;1171663;-802829;282334;-1085163;
6194;860014923;2019-12-31;2019;MILES;196503911;0;196503911;160681629;8725353;27096929;7367757;0;2159064;0;27145875;10107707;17038168;
6195;860014923;2019-12-31;2018;MILES;197988982;0;197988982;148219991;16881601;32887390;4241172;0;4779605;0;37383171;15894633;21488538;
6196;800181122;2019-12-31;2019;MILES;56036;0;56036;199054;0;-143018;843;46946;2109;0;64020323;-73144;64093467;
6197;800181122;2019-12-31;2018;MILES;86030;0;86030;242135;0;-156105;5965537;11075;5968495;0;-25266738;339635;-25606373;
6198;891102723;2019-12-31;2019;MILES;506642667;486947884;19694783;45403430;0;-25708647;20022643;1598296;3219605;11239494;3220598;3963256;-742658;
6199;891102723;2019-12-31;2018;MILES;461935968;432630535;29305433;40379782;0;-11074349;14748090;2219315;1776528;8176566;6963863;16891298;-9927435;
6200;900626723;2019-12-31;2019;MILES;0;0;0;366360;0;-366360;5597327;1649938;3532096;593508;-3488021;140178;-3628199;
6201;900626723;2019-12-31;2018;MILES;0;0;0;1762834;0;-1762834;3905004;2645895;427460;2832807;-5053466;425952;-5479418;
6202;860049921;2019-12-31;2019;MILES;148579367;118885894;29693473;10611478;0;19081995;16392593;22831911;12621135;4280107;17099614;5578656;11520958;
6203;860049921;2019-12-31;2018;MILES;120234880;95341173;24893707;10797658;0;14096049;17318355;0;12592814;28000;17327354;2975999;14351355;
6204;900139569;2019-12-31;2019;MILES;24913312;20182947;4730365;6694477;1214124;-3178236;355947;0;0;0;-3534183;47750;-3581933;
6205;900139569;2019-12-31;2018;MILES;22292542;19468142;2824400;6642978;976420;-4794998;447313;0;0;0;-5242311;67191;-5309502;
6206;800221843;2019-12-31;2019;MILES;969026;763786;205240;283284;169057;-247101;1393;75042;240;151737;-171559;112452;-284011;
6207;800221843;2019-12-31;2018;MILES;881807;702638;179169;290460;126085;-237376;722;98576;499;496397;160222;136896;23326;
6208;900854544;2019-12-31;2019;MILES;440372;0;440372;493044;0;-52672;11342;70;445;0;-63639;-61202;-2437;
6209;900854544;2019-12-31;2018;MILES;566201;0;566201;611179;0;-44978;64227;1677;32495;0;-78387;94937;-173324;
6210;860008018;2019-12-31;2019;MILES;212549890;163028633;49521257;9714973;0;39806284;13617201;58922;2852032;10965;28915811;7007054;21908757;
6211;860008018;2019-12-31;2018;MILES;186418213;151953647;34464566;8079452;0;26385114;2763717;92193;1258946;13197;24682939;10707408;13975531;
6212;900280623;2019-12-31;2019;MILES;202853;86366;116487;642385;0;-525898;84024;80682;91810;16657;-582137;34904;-617041;
6213;900280623;2019-12-31;2018;MILES;406758;180557;226201;828853;0;-602652;45400;5030;152324;35902;-464856;109353;-574209;
6214;800175223;2019-12-31;2019;MILES;50146649;43569696;6576953;934776;5995525;-353348;942515;0;0;1705809;409946;409106;840;
6215;800175223;2019-12-31;2018;MILES;42294844;36372167;5922677;890149;6947253;-1914725;352388;0;0;1122080;-1145033;-12801;-1132232;
6216;802022622;2019-12-31;2019;MILES;105049993;100344163;4705830;2912006;0;1793824;0;2328667;428590;975955;869702;164949;191389;
6217;802022622;2019-12-31;2018;MILES;67611057;63505277;4105780;2776065;0;1329715;0;1210376;277723;344377;741439;95012;1910759;
6218;830507323;2019-12-31;2019;MILES;4471039;3429938;1041101;436284;0;604817;63872;290233;0;0;250712;99779;150933;
6219;830507323;2019-12-31;2018;MILES;3407803;2559838;847965;364455;0;483510;60119;269414;0;0;153977;55332;98645;
6220;900186129;2019-12-31;2019;MILES;14378389;8326650;6051739;0;2954;6048785;106923;50312;6721;50806;5949077;1252911;4696166;
6221;900186129;2019-12-31;2018;MILES;16882106;10674726;6207380;0;2860;6204520;64674;630;84543;105955;6329714;1266096;5063618;
6222;901112025;2019-12-31;2019;MILES;220420386;211174421;9245965;5677258;0;3568707;1950;177848;25456879;61;219821329;10206219;209615110;
6223;901112025;2019-12-31;2018;MILES;97134223;87355564;9778659;343640;0;9435019;60383;262;12374408;124561;114248213;8816584;105431629;
6224;900498132;2019-12-31;2019;MILES;26336111;0;26336111;1351469;3460404;21524238;1761973;1619705;0;2192447;68229735;5695566;62534169;
6225;900498132;2019-12-31;2018;MILES;67134504;0;67134504;591747;5037;66537720;1176290;54391;666699;409737;66383475;376563;66006912;
6226;830060020;2019-12-31;2019;MILES;51430908;41117990;10312918;1743499;2028103;6541316;276280;0;25643;0;6500811;2841270;3659541;
6227;830060020;2019-12-31;2018;MILES;32902138;25241376;7660762;1558350;2922705;3179707;28533;0;82386;0;3725321;1371571;2353750;
6228;860519235;2019-12-31;2019;MILES;105001475;49657555;55343920;7875426;42473278;4995216;4943881;508308;416689;13308832;13268548;4622371;8646177;
6229;860519235;2019-12-31;2018;MILES;99541365;45942609;53598756;8794431;42311108;2493217;2370996;133081;186655;13305728;13481523;4469950;9011573;
6230;900123726;2019-12-31;2019;MILES;0;0;0;379254;0;-379254;72;343;0;1;24530216;111427;24418789;
6231;900123726;2019-12-31;2018;MILES;0;0;0;760122;0;-760122;121;9897;0;0;23896896;248062;23648834;
6232;860524750;2019-12-31;2019;MILES;89401726;66386424;23015302;4293364;13743383;4978555;1673180;516164;807870;547482;5005452;2736736;2268716;
6233;860524750;2019-12-31;2018;MILES;68917238;50579880;18337358;3012765;11754688;3569905;1518224;863898;773180;363607;2601511;1048561;1552950;
6234;890800148;2019-12-31;2019;MILES;213584691;165107498;48477193;14048919;17664670;16763604;269385;4083863;294671;3342636;16047663;4063051;12126772;
6235;890800148;2019-12-31;2018;MILES;192804057;145378420;47425637;12149646;18078863;17197128;808355;2812499;529233;699569;14805076;6724991;8072526;
6236;860006928;2019-12-31;2019;MILES;88851901;0;88851901;82788687;0;6063214;19942586;11527;13875951;1170180;1658700;1236095;422605;
6237;860006928;2019-12-31;2018;MILES;75128568;0;75128568;68516916;0;6611652;10470175;11153;8015297;1170409;6180003;2233324;3946679;
6238;800022127;2019-12-31;2019;MILES;288552520;292764665;-4212145;9776983;0;-13989128;425861;212425;18939121;1634581;-20563353;1896448;-22459801;
6239;800022127;2019-12-31;2018;MILES;263688648;221888036;41800612;1262558;0;40538054;7730507;1058434;10305104;525451;55709046;14142095;41566951;
6240;800157686;2019-12-31;2019;MILES;46688704;44817615;1871089;1607031;0;264058;206883;1359;10429;1923;409549;129557;279992;
6241;800157686;2019-12-31;2018;MILES;44793296;42653272;2140024;1631567;0;508457;300590;135071;10286;7913;128439;125007;3432;
6242;830129289;2019-12-31;2019;MILES;116690553;99094657;17595896;7224444;0;10371452;9354347;1634197;397440;3154006;3319094;1867013;1452081;
6243;830129289;2019-12-31;2018;MILES;122080900;101856376;20224524;7811229;0;12413295;8112592;506539;675042;363426;3543077;-541792;4084869;
6244;805017133;2019-12-31;2019;MILES;25769216;17013895;8755321;3442769;4277397;1035155;2514214;494922;1523601;101119;-349261;114188;-463449;
6245;805017133;2019-12-31;2018;MILES;37565208;24718573;12846635;4027891;3999584;4819160;4168008;948453;2607639;161390;2471728;1276917;1194811;
6246;900397327;2019-12-31;2019;MILES;14824271;0;14824271;15295;0;14808976;0;7621545;0;0;7187431;0;7187431;
6247;900397327;2019-12-31;2018;MILES;12511327;0;12511327;15759;0;12495568;0;7615132;0;0;4880436;5167;4875269;
6248;900571526;2019-12-31;2019;MILES;416676;0;416676;389770;0;26906;24239;2726;0;66265;984237;24785;959452;
6249;900571526;2019-12-31;2018;MILES;747320;0;747320;397261;0;350059;276016;397538;436;1304558;996134;41128;955006;
6250;860027326;2019-12-31;2019;MILES;52439676;39854839;12584837;2436714;7208249;2939874;1304633;130719;0;421025;1925547;971794;953753;
6251;860027326;2019-12-31;2018;MILES;44268918;33979912;10289006;2283565;6228829;1776612;1399681;103680;0;412688;685939;448561;237378;
6252;900042741;2019-12-31;2019;MILES;4513681;4535161;-21480;619274;0;-640754;105297;592757;0;4352;-1334456;-399900;-934556;
6253;900042741;2019-12-31;2018;MILES;7963295;8275102;-311807;599381;0;-911188;615922;675876;0;2624643;421657;362477;59180;
6254;900636944;2019-12-31;2019;MILES;6147836;0;6147836;2368244;0;3779592;1445886;1208144;211794;19769;-3701477;1255893;-4957370;
6255;900636944;2019-12-31;2018;MILES;28000;0;28000;2209588;0;-2181588;1025446;2212771;158908;97895;-19871544;-1133024;-18738520;
6256;830119051;2019-12-31;2019;MILES;57069034;31785710;25283324;16007745;12090139;-2814560;10935275;4561278;6859128;398142;-8644280;320842;-8965122;
6257;830119051;2019-12-31;2018;MILES;71627984;42485472;29142512;14081264;12398811;2662437;10331472;2660287;4383558;677957;-3041264;-97680;-2943584;
6258;830058632;2019-12-31;2019;MILES;0;0;0;45459;0;-45459;23;177;0;0;13961300;6;13961294;
6259;830058632;2019-12-31;2018;MILES;0;0;0;28869;0;-28869;0;0;13651;0;17937886;13;17937873;
6260;813003433;2019-12-31;2019;MILES;9332312;6625941;2706371;1867608;0;838763;436970;15477;20608;71404;472656;179767;292889;
6261;813003433;2019-12-31;2018;MILES;15989465;12982945;3006520;1914707;0;1091813;432509;15048;19039;122055;785350;362552;422798;
6262;860002519;2019-12-31;2019;MILES;4218078;0;4218078;334091;0;3883987;0;3484538;1032104;81637;36809317;162387;36646930;
6263;860002519;2019-12-31;2018;MILES;2174858;0;2174858;653050;0;1521808;0;9837157;1032720;0;-8738242;453645;-9191887;
6264;900123725;2019-12-31;2019;MILES;0;0;0;29767;0;-29767;45167;343;62482;0;-8797087;5284;-8802371;
6265;900123725;2019-12-31;2018;MILES;0;0;0;122744;0;-122744;57074;0;42507;0;-35773361;12783;-35786144;
6266;800073741;2019-12-31;2019;MILES;4891801;3689124;1202677;690921;77923;433833;0;83521;0;61990;412302;119720;292582;
6267;800073741;2019-12-31;2018;MILES;3137901;2172880;965021;627598;59219;278204;0;85474;0;65078;257808;65115;192693;
6268;860532426;2019-12-31;2019;MILES;10292511;6497356;3795155;3202017;0;593138;520637;1846608;0;1009964;-205773;-254991;49218;
6269;860532426;2019-12-31;2018;MILES;11415742;8156833;3258909;4319985;0;-1061076;121098;1079861;0;1452079;432182;-103109;535291;
6270;830058148;2019-12-31;2019;MILES;35562781;10607114;24955667;23179250;0;1776417;2325111;769017;193747;9072263;7948299;-38370;7986669;
6271;830058148;2019-12-31;2018;MILES;30432256;17125079;13307177;17822439;0;-4515262;874600;518235;14209;4652742;-1241146;282468;-1523614;
6272;890101648;2019-12-31;2019;MILES;8788105;7757307;1030798;423997;0;606801;37614;1203518;180074;383810;-70447;183477;-253924;
6273;890101648;2019-12-31;2018;MILES;6469450;7124197;-654747;405505;0;-1060252;14637;16803;180082;3323525;2411915;512255;1899660;
6274;860003829;2019-12-31;2019;MILES;2754087;0;2754087;708871;0;2045216;342025;4;225776;1698442;3627405;720036;2907369;
6275;860003829;2019-12-31;2018;MILES;2683754;0;2683754;816660;0;1867094;512466;50264;230394;5832792;7367550;538859;6828691;
6276;900124227;2019-12-31;2019;MILES;0;0;0;30013;0;-30013;8;343;0;0;-77104395;341;-77104736;
6277;900124227;2019-12-31;2018;MILES;0;0;0;37585;0;-37585;0;0;0;0;-40034236;463;-40034699;
6278;890911327;2019-12-31;2019;MILES;53908954;32270947;21638007;8875383;9832141;2930483;2757991;0;260090;1083907;1516489;366235;1150254;
6279;890911327;2019-12-31;2018;MILES;52149630;31063143;21086487;8801628;8034497;4250362;2059581;61848;148043;446650;2723626;975050;1748576;
6280;800153832;2019-12-31;2019;MILES;19316770;10656315;8660455;1522825;6169591;968039;0;1808133;0;1170544;330450;73709;256741;
6281;800153832;2019-12-31;2018;MILES;20765250;12028793;8736457;1476570;6342490;917397;0;1596871;0;1973234;1293760;798923;494837;
6282;860401339;2019-12-31;2019;MILES;16088782;4138108;11950674;432140;0;11518534;908678;0;2203736;791607;9835316;3037473;6797843;
6283;860401339;2019-12-31;2018;MILES;12601407;4430508;8170899;852793;0;7318106;1519191;2415;2248306;15618;22286780;1456805;20829975;
6284;830011625;2019-12-31;2019;MILES;2011875;1384662;627213;523801;0;103412;6828;21817;144669;222935;260562;149560;111002;
6285;830011625;2019-12-31;2018;MILES;2039063;1294025;745038;507002;0;238036;0;291676;0;173955;120315;91455;28860;
6286;860066524;2019-12-31;2019;MILES;7327052;144383;7182669;5385429;45343;1751897;1056353;1212149;477443;806586;754597;-1421571;2176168;
6287;860066524;2019-12-31;2018;MILES;5329058;149216;5179842;3951558;70465;1157819;746443;152256;11223;1136328;1119472;-110369;1229841;
6288;900394734;2019-12-31;2019;MILES;1844469;1061869;782600;418570;0;364030;23741;2668;169;84727;422517;139431;283086;
6289;900394734;2019-12-31;2018;MILES;1968908;1259128;709780;184469;0;525311;31959;205959;0;14376;301769;0;301769;
6290;800213511;2019-12-31;2019;MILES;47925666;18981420;28944246;3496524;12955443;12492279;2951818;403821;2162172;920064;12218876;4154293;8064583;
6291;800213511;2019-12-31;2018;MILES;42428993;16506354;25922639;3154535;12115099;10653005;1449376;279763;1730651;316510;10971027;4751980;6219047;
6292;800130149;2019-12-31;2019;MILES;99911972;79483606;20428366;3861716;9503712;7062938;1673955;187008;2630;2158273;7119125;3165586;3953539;
6293;800130149;2019-12-31;2018;MILES;86152285;67514044;18638241;3999239;8391847;6247155;2236902;180544;4265;2045201;5060368;1306089;3754279;
6294;890903436;2019-12-31;2019;MILES;129173991;87673231;41500760;9352205;30427957;1720598;1618692;831772;760855;2138991;2169997;1167764;1002233;
6295;890903436;2019-12-31;2018;MILES;122444423;80457152;41987271;8251849;34754402;-1018980;770329;751635;552722;1391824;4017273;1118019;2899254;
6296;830031632;2019-12-31;2019;MILES;29629218;19276044;10353174;1753188;0;8599986;2820495;4128078;194993;0;1846406;1284412;561994;
6297;830031632;2019-12-31;2018;MILES;25972044;15316353;10655691;1514723;0;9140968;3260635;3797644;58078;0;2140767;1525227;615540;
6298;900308342;2019-12-31;2019;MILES;7142004;0;7142004;199186;62091;6880727;79243;1375470;150219;0;5576233;10255;5565978;
6299;900308342;2019-12-31;2018;MILES;4802466;0;4802466;57178;1265;4744023;24313;1434350;103900;134878;3524138;57177;3466961;
6300;900397334;2019-12-31;2019;MILES;10518781;10089803;428978;1014020;0;-585042;1168665;0;2505151;1698153;2449597;-2170238;4619835;
6301;900397334;2019-12-31;2018;MILES;16398935;24664066;-8265131;890064;0;-9155195;184240;1197030;29240;477937;-10029288;0;-10029288;
6302;900483131;2019-12-31;2019;MILES;496266;1874352;-1378086;186530;0;-1564616;0;1000433;0;0;-2390600;0;-2390600;
6303;900483131;2019-12-31;2018;MILES;1810974;4336720;-2525746;836244;0;-3361990;0;328695;0;399457;-3291228;0;-3291228;
6304;800002030;2019-12-31;2019;MILES;17190098;9939013;7251085;2183904;4988093;79088;241;411393;95654;736706;499814;207209;292605;
6305;800002030;2019-12-31;2018;MILES;14259471;8567979;5691492;2256821;5085109;-1650438;926;464031;82951;2316799;284355;137610;146745;
6306;830113435;2019-12-31;2019;MILES;52044;37118;14926;1922104;0;-1907178;305221;0;0;840000;-1371476;0;-1371476;
6307;830113435;2019-12-31;2018;MILES;50448;242914;-192466;522823;0;-715289;630553;0;978;710000;-317182;0;-317182;
6308;800237631;2019-12-31;2019;MILES;799537;0;799537;692053;2141;105343;3509;16157;0;0;85677;38073;47604;
6309;800237631;2019-12-31;2018;MILES;948121;0;948121;1135613;26685;-214177;7383;144763;0;82538;-283785;77913;-361698;
6310;830021747;2019-12-31;2019;MILES;1537164;0;1537164;1619521;0;-82357;2017;145403;149278;2503833;2423334;741455;1681879;
6311;830021747;2019-12-31;2018;MILES;1699862;0;1699862;990973;0;708889;762;1895516;272736;202383;-712270;116561;-828831;
6312;890300346;2019-12-31;2019;MILES;971223000;742711000;228512000;0;290274000;-61762000;85873000;0;9261000;0;-109023000;11422000;-120445000;
6313;890300346;2019-12-31;2018;MILES;1126956000;860115000;266841000;0;340323000;-73482000;91094000;201501000;11954000;0;-349532000;-7390000;-342142000;
6314;890304140;2019-12-31;2019;MILES;83733752;61600266;22133486;5448469;8428523;8256494;1806425;271070;2756915;1239628;9830092;5029825;4800267;
6315;890304140;2019-12-31;2018;MILES;75647359;56997768;18649591;5538434;8845782;4265375;683821;239343;0;1326012;4668223;1751841;2916382;
6316;830001637;2019-12-31;2019;MILES;175232182;157581478;17650704;6613132;10794419;243153;1379111;2277875;1035814;58898;-3672194;233554;-3905748;
6317;830001637;2019-12-31;2018;MILES;146846915;129245466;17601449;7050397;9342850;1208202;2914119;1005910;1248993;53218;-105736;-12938;-92798;
6318;890315540;2019-12-31;2019;MILES;239108928;171771532;67337396;7055695;58770448;1511253;6432320;0;0;0;3633927;1049016;2584911;
6319;890315540;2019-12-31;2018;MILES;228332789;160556985;67775804;7350076;57714192;2711536;2251728;0;0;0;10969819;1285325;9684494;
6320;860000537;2019-12-31;2019;MILES;47217124;18942726;28274398;3601584;0;24672814;16661727;14818331;11077;410466;-6385701;-119147;-6266554;
6321;860000537;2019-12-31;2018;MILES;45103541;19388310;25715231;4374113;0;21341118;17714857;6616820;21562;3031243;62246;1300038;-1237792;
6322;900449442;2019-12-31;2019;MILES;1026288;603754;422534;93146;0;329388;16415;43;0;2119176;2432106;609287;1822819;
6323;900449442;2019-12-31;2018;MILES;873629;91926;781703;662872;0;118831;2175;50289;0;8185448;8251815;239671;8012144;
6324;891501133;2019-12-31;2019;MILES;341092850;307340654;33752196;14287563;19985080;-520447;36059815;4831530;332075;1515720;-13876168;5302080;-19178248;
6325;891501133;2019-12-31;2018;MILES;354193285;296974238;57219047;15134230;16447586;25637231;30046728;4505317;389406;3152117;7741959;5606569;2135390;
6326;900353530;2019-12-31;2019;MILES;18800580;14745657;4054923;3353569;0;701354;109326;2905835;0;3844728;1818065;718988;1099077;
6327;900353530;2019-12-31;2018;MILES;17154255;12571863;4582392;3179494;0;1402898;29842;3041340;0;3412611;1678170;601620;1076550;
6328;800161734;2019-12-31;2019;MILES;0;0;0;0;0;0;172261;0;0;2783;30991263;0;30991263;
6329;800161734;2019-12-31;2018;MILES;0;0;0;3900;0;-3900;180040;0;0;1144;4096510;1112;4095398;
6330;819003334;2019-12-31;2019;MILES;1386875;1146930;239945;199519;0;40426;8751;29812;0;0;64612;-12451;77063;
6331;819003334;2019-12-31;2018;MILES;1649520;1548048;101472;146718;0;-45246;23024;14673;0;0;-86917;-123474;36557;
6332;806004930;2019-12-31;2019;MILES;1685940;0;1685940;2983395;1071487;-2368942;2730528;19771504;1667020;34391477;11187523;-1466184;12653707;
6333;806004930;2019-12-31;2018;MILES;48971979;39983141;8988838;2099396;6893597;-4155;8872649;8038907;2593951;682642;-13639118;570395;-14209513;
6334;830093741;2019-12-31;2019;MILES;38831286;33922825;4908461;1318134;10569;3579758;3932678;339008;1823923;885387;2017382;677233;1340149;
6335;830093741;2019-12-31;2018;MILES;34517936;31282823;3235113;1154687;11577;2068849;1382475;6004;666543;1001482;2348395;618306;1730089;
6336;890910447;2019-12-31;2019;MILES;31008560;25901261;5107299;2219045;833609;2054645;0;1089124;0;129540;1095061;228530;866531;
6337;890910447;2019-12-31;2018;MILES;35788564;31703421;4085143;2282717;619157;1183269;0;691260;0;10036;502045;-38769;540814;
6338;816001182;2019-12-31;2019;MILES;2426428641;2048586173;377842468;114596897;122878511;140367060;50804689;16474699;8452806;1608522;86239971;47003346;39236625;
6339;816001182;2019-12-31;2018;MILES;2035077279;1718819439;316257840;110994956;114319433;90943451;32862789;9571221;3571629;3905915;59297014;47774421;11522593;
6340;900674139;2019-12-31;2019;MILES;670800;0;670800;1168175;0;-497375;749363;0;12410;991495;-121297;36499;-157796;
6341;900674139;2019-12-31;2018;MILES;737469;0;737469;1746656;0;-1009187;1551011;190635;7781;688392;-9414514;-856659;-8557855;
6342;811037742;2019-12-31;2019;MILES;972631;0;972631;1487878;0;-515247;549697;0;521168;0;-543776;30549;-574325;
6343;811037742;2019-12-31;2018;MILES;1698467;48998;1649469;1317497;0;331972;5123780;0;5760480;0;968672;285083;683589;
6344;804000690;2019-12-31;2019;MILES;1446396;604931;841465;536878;0;304587;31875;17656;5314;23972;284342;-156599;440941;
6345;804000690;2019-12-31;2018;MILES;2110205;1123624;986581;613939;0;372642;29514;22764;352;10918;331634;23127;308507;
6346;800013736;2019-12-31;2019;MILES;22579846;18839700;3740146;1847906;0;1892240;1193707;47725;0;1077303;2125811;137962;1987849;
6347;800013736;2019-12-31;2018;MILES;25462652;22040133;3422519;1900877;0;1521642;990688;67335;99477;1111244;2496916;385058;2111858;
6348;890328053;2019-12-31;2019;MILES;111801;48980;62821;73565;0;-10744;0;0;8935128;101370;9535304;2476754;7058550;
6349;890328053;2019-12-31;2018;MILES;108355;26858;81497;63492;0;18005;0;0;8082833;0;8940721;2631260;6309461;
6350;901213639;2019-12-31;2019;MILES;0;0;0;2082;0;-2082;0;0;0;0;-237813;13;-237826;
6351;901213639;2019-12-31;2018;MILES;0;0;0;102842;0;-102842;0;0;0;0;2355299;0;2355299;
6352;890312765;2019-12-31;2019;MILES;237474101;205265935;32208166;18038028;0;14170138;2388934;0;1324086;0;16285292;7338869;8946423;
6353;890312765;2019-12-31;2018;MILES;285113915;252363155;32750760;15682866;0;17067894;3937317;0;2934055;0;15672487;7237925;8434562;
6354;900909553;2019-12-31;2019;MILES;1919;0;1919;33926;0;-32007;26101;0;0;94412;2916245;18504;2897741;
6355;900909553;2019-12-31;2018;MILES;1860;0;1860;28340;0;-26480;200;4959;0;0;-9095;59902;-68997;
6356;900111343;2019-12-31;2019;MILES;78848234;63094146;15754088;8293000;0;7461088;759593;16205;468300;0;7153590;3724498;3429092;
6357;900111343;2019-12-31;2018;MILES;56552061;46639058;9913003;6128538;0;3784465;822077;56630;691062;244500;3841320;1681514;2159806;
6358;900608144;2019-12-31;2019;MILES;24335825;0;24335825;208898;0;24126927;556026;0;0;28497785;52068686;8393800;43674886;
6359;900608144;2019-12-31;2018;MILES;23080876;0;23080876;145927;0;22934949;390112;0;0;49723;22594560;5760793;16833767;
6360;900888439;2019-12-31;2019;MILES;11249284;4986761;6262523;4653683;0;1608840;457350;109508;3321040;6443842;-6035504;3178219;-9213723;
6361;900888439;2019-12-31;2018;MILES;20482713;15103121;5379592;25738225;0;-20358633;852259;2516337;15711739;1263849;-6751641;6548866;-13300507;
6362;860534736;2019-12-31;2019;MILES;0;0;0;2021;0;-2021;0;0;0;0;607330;0;607330;
6363;860534736;2019-12-31;2018;MILES;0;0;0;1913;0;-1913;0;0;0;0;-1913;0;-1913;
6364;900354036;2019-12-31;2019;MILES;75391616;67022104;8369512;5369957;0;2999555;2492996;17429;613267;563198;1137733;337744;799989;
6365;900354036;2019-12-31;2018;MILES;72576767;64369243;8207524;5605124;0;2602400;1973427;20992;62552;221985;1711087;624891;1086196;
6366;830050633;2019-12-31;2019;MILES;4661941;3061932;1600009;1144283;815861;-360135;239355;79743;456285;276908;53960;0;53960;
6367;830050633;2019-12-31;2018;MILES;3769672;1479718;2289954;2734072;791925;-1236043;1099827;55781;865008;447473;-1079170;0;-1079170;
6368;900679739;2019-12-31;2019;MILES;0;0;0;9943909;0;-9943909;2926554;668112;806;1240805;-12641633;-72084;-12569549;
6369;900679739;2019-12-31;2018;MILES;0;0;0;10323330;0;-10323330;1269267;1326592;180;4753;-15261766;428925;-15690691;
6370;900866440;2019-12-31;2019;MILES;30544777;20090554;10454223;1852375;0;8601848;6939203;141130;24904719;3780855;30207089;1654184;28552905;
6371;900866440;2019-12-31;2018;MILES;29930847;18815973;11114874;2703837;0;8411037;6696308;3905776;18811320;32299;16652572;2188836;14463736;
6372;860002537;2019-12-31;2019;MILES;95321614;65394182;29927432;2508719;4627157;22791556;827077;536021;2094474;0;28503736;7643395;20860341;
6373;860002537;2019-12-31;2018;MILES;85504029;62076991;23427038;2337976;3664565;17424497;716675;0;2182223;146235;24135174;5258144;18877030;
6374;800197463;2019-12-31;2019;MILES;816758680;719609881;97148799;32733729;126556190;-62141120;725112069;9802351;671757313;23138501;-102159726;-28657309;-73502417;
6375;800197463;2019-12-31;2018;MILES;762015290;648452420;113562870;23175271;120129988;-29742389;83873294;2304662;46682804;19718325;-49519216;-5938733;-43580483;
6376;900354637;2019-12-31;2019;MILES;33405669;31612309;1793360;3588825;0;-1795465;6190444;2763711;3231162;2762697;-4609266;-12739742;8130476;
6377;900354637;2019-12-31;2018;MILES;40924625;72757521;-31832896;5868742;0;-37701638;10554102;1247806;3994913;15374718;-32071303;0;-32071303;
6378;830146338;2019-12-31;2019;MILES;6622908;1837107;4785801;22252;0;4763549;147028;1030916;666929;1472984;5725518;154553;5570965;
6379;830146338;2019-12-31;2018;MILES;345851;227120;118731;173994;0;-55263;1175986;23379930;890977;51778150;28057948;3749557;24308391;
6380;800065539;2019-12-31;2019;MILES;27726357;0;27726357;33162915;0;-5436558;1585922;3001735;0;201081;-9823134;1798331;-11621465;
6381;800065539;2019-12-31;2018;MILES;29962850;0;29962850;30817180;0;-854330;2195161;3673265;0;0;-3243278;1929636;-5172914;
6382;830138743;2019-12-31;2019;MILES;4542184;2352519;2189665;1186733;261151;741781;0;831163;0;5357;-84025;0;-84025;
6383;830138743;2019-12-31;2018;MILES;5169586;1798292;3371294;1356853;739130;1275311;0;1360468;0;299798;214641;105938;108703;
6384;900658437;2019-12-31;2019;MILES;0;0;0;38011;0;-38011;1100;0;0;0;-39111;3734;-42845;
6385;900658437;2019-12-31;2018;MILES;0;0;0;37141;0;-37141;1059;0;0;0;-38200;9262;-47462;
6386;830000640;2019-12-31;2019;MILES;48794581;19277600;29516981;12724639;15841415;950927;853801;857402;160842;3408307;5777231;1815889;3961342;
6387;830000640;2019-12-31;2018;MILES;43277621;16923699;26353922;11551912;14960873;-158863;845730;185563;291822;1671992;2945280;713660;2231620;
6388;900123136;2019-12-31;2019;MILES;0;0;0;119077;0;-119077;65678;25447;0;0;-1462174;60681;-1522855;
6389;900123136;2019-12-31;2018;MILES;0;0;0;355017;0;-355017;550;137;0;0;2508595;22659;2485936;
6390;900038933;2019-12-31;2019;MILES;145722294;114002001;31720293;33310728;0;-1590435;4949597;230146;0;1380654;-4273167;-228000;-4045167;
6391;900038933;2019-12-31;2018;MILES;152131725;118649702;33482023;28027601;0;5454422;4223306;882917;0;691270;1131389;1307605;-176216;
6392;800150443;2019-12-31;2019;MILES;33097289;27070789;6026500;3884400;0;2142100;380008;27154;37971;581307;2354216;570925;1783291;
6393;800150443;2019-12-31;2018;MILES;25112519;17816796;7295723;4246348;0;3049375;252332;76738;69671;371449;3161425;608376;2553049;
6394;860513290;2019-12-31;2019;MILES;132865905;81884325;50981580;8995332;3925072;38061176;5781196;39880589;111981;6708882;4127370;8927916;-4800546;
6395;860513290;2019-12-31;2018;MILES;135218745;87644384;47574361;9565135;3388298;34620928;10654734;22427463;46882;6709276;-185757;-318909;133152;
6396;900497754;2019-12-31;2019;MILES;7817177;7206747;610430;299244;213798;97388;33176;47370;24524;0;52568;41720;10848;
6397;900497754;2019-12-31;2018;MILES;5698898;4733272;965626;386537;146596;432493;22760;44244;11012;0;410902;145285;265617;
6398;800255754;2019-12-31;2019;MILES;98484221;78355813;20128408;13606543;0;6521865;5182095;327129;0;1628483;5348280;0;3181596;
6399;800255754;2019-12-31;2018;MILES;100430755;75222626;25208129;12379868;0;12828261;3889343;2931186;0;0;9304957;0;4467710;
6400;830070851;2019-12-31;2019;MILES;1240489;1034548;205941;198594;0;7347;335905;61336;191991;337018;139115;341555;-202440;
6401;830070851;2019-12-31;2018;MILES;1910335;1110909;799426;265972;4040;529414;504694;166132;373207;217513;449308;107572;341736;
6402;900086745;2019-12-31;2019;MILES;20971878;1685398;19286480;9035179;8275410;1975891;3642149;918126;3328549;3669991;4277071;737950;3539121;
6403;900086745;2019-12-31;2018;MILES;37486859;15711268;21775591;10385728;7468186;3921677;2430499;527694;2416013;3341756;7498191;1228118;6270073;
6404;817000747;2019-12-31;2019;MILES;162300049;139173259;23126790;4312603;8339077;10475110;5714444;0;0;0;8685212;2656923;6028289;
6405;817000747;2019-12-31;2018;MILES;155168642;127909555;27259087;5079003;9940897;12239187;1573598;0;0;0;10526089;2259176;8266913;
6406;860058070;2019-12-31;2019;MILES;920970458;841480028;79490430;144804759;14312918;-79627247;54390158;66571467;7871697;2481204;-217497473;-7261364;-210236109;
6407;860058070;2019-12-31;2018;MILES;775476991;657734691;117742300;57308676;14903573;45530051;27662636;10227472;4285978;3215054;17710680;-2630824;20341504;
6408;860052988;2019-12-31;2019;MILES;26610606;21279424;5331182;2291406;2031479;1008297;512187;73428;132234;428672;942471;383588;558883;
6409;860052988;2019-12-31;2018;MILES;24553368;19750104;4803264;1874842;1977331;951091;535921;65052;173903;315309;934743;283772;650971;
6410;800048943;2019-12-31;2019;MILES;555293580;492506772;62786808;21378569;20335734;21072505;38733791;2212850;5118509;0;-11171763;1739782;-12911545;
6411;800048943;2019-12-31;2018;MILES;549666868;478204519;71462349;21093864;15677003;34691482;23584756;30136791;2461475;0;-15198019;-18366338;3168319;
6412;800208785;2019-12-31;2019;MILES;190702359;130055539;60646820;16934034;33891238;9821548;106779;0;0;552575;10267344;3796485;6470859;
6413;800208785;2019-12-31;2018;MILES;173221605;111547698;61673907;15256196;31377242;15040469;0;107704;233277;0;15166042;6228534;8937508;
6414;830114143;2019-12-31;2019;MILES;2014932;33369;1981563;2398632;0;-417069;1220746;125878;19906;1256943;-486844;131130;-617974;
6415;830114143;2019-12-31;2018;MILES;641839;133661;508178;2883784;0;-2375606;537745;44149;328023;1182821;-1446656;90057;-1536713;
6416;900064443;2019-12-31;2019;MILES;127119987;97720382;29399605;2442291;16571882;10385432;0;3563156;0;4273898;13697272;3783630;9913642;
6417;900064443;2019-12-31;2018;MILES;73119891;67452549;5667342;2083698;0;3583644;245263;318586;119942;226778;5329041;1375408;3953633;
6418;890100477;2019-12-31;2019;MILES;36666899;19145601;17521298;11637442;11406611;-5522755;0;0;290134;0;1389042;787770;601272;
6419;890100477;2019-12-31;2018;MILES;44765669;19537582;25228087;12925607;12991181;-688701;0;287622;167459;0;-808864;265350;-1074214;
6420;811023657;2019-12-31;2019;MILES;23710123;21295421;2414702;2345553;46669;22480;2617523;0;2079407;1842066;711904;429324;282580;
6421;811023657;2019-12-31;2018;MILES;25101277;21749904;3351373;2365282;51407;934684;905649;0;9;504574;476032;271395;204637;
6422;900044844;2019-12-31;2019;MILES;23547947;17635786;5912161;1011206;4831956;68999;3434815;1523738;27853;1274588;-4052787;21297;-4074084;
6423;900044844;2019-12-31;2018;MILES;27754658;20783233;6971425;1928868;4810830;231727;4359878;1579863;70062;1412356;-4264706;132828;-4397534;
6424;800173155;2019-12-31;2019;MILES;230222194;200411626;29810568;12358242;4275120;13177206;4817923;3179836;0;1266837;6446284;1210000;5236284;
6425;800173155;2019-12-31;2018;MILES;210459095;184063134;26395961;13477387;4161405;8757169;4134203;1627434;0;3496670;6492202;1225940;5266262;
6426;830047444;2019-12-31;2019;MILES;42664734;29207529;13457205;6451019;1776101;5230085;1984569;846211;81836;320488;2801629;742156;2059473;
6427;830047444;2019-12-31;2018;MILES;37538041;25025064;12512977;6694129;1156471;4662377;1692005;1453369;452223;379407;2348633;557208;1791425;
6428;800202510;2019-12-31;2019;MILES;32557131;20298280;12258851;11202803;0;1056048;490471;24512;157977;2411860;3169891;519500;2650391;
6429;800202510;2019-12-31;2018;MILES;31782922;20430375;11352547;9523723;0;1828824;423672;534849;77504;1979589;4131260;1248768;2882492;
6430;900463395;2019-12-31;2019;MILES;3909370;2620984;1288386;887763;1097692;-697069;584897;815776;463926;1228312;-405504;65143;-470647;
6431;900463395;2019-12-31;2018;MILES;23296585;22244244;1052341;1342010;685896;-975565;586285;143879;668626;1553073;515970;198330;317640;
6432;900572444;2019-12-31;2019;MILES;21614453;17996059;3618394;1044302;2256311;317781;334623;0;0;891422;257291;51215;206076;
6433;900572444;2019-12-31;2018;MILES;19833699;16515514;3318185;818858;1977423;521904;403080;0;0;33;357937;120000;237937;
6434;800148462;2019-12-31;2019;MILES;150240775;135462911;14777864;6573820;0;8204044;7507526;2052478;8782140;0;8372500;2522172;5850328;
6435;800148462;2019-12-31;2018;MILES;137449912;135512654;1937258;7387481;0;-5450223;1254563;871788;1003197;0;1677423;-4260230;5937653;
6436;800038391;2019-12-31;2019;MILES;5711132;14786760;-9075628;1685795;0;-10761423;45528653;3067079;45634293;0;1975498;9199678;-7224180;
6437;800038391;2019-12-31;2018;MILES;6817142;10641218;-3824076;2582286;0;-6406362;31623486;74418;30971289;0;6162843;-11628587;17791430;
6438;830024043;2019-12-31;2019;MILES;331795617;277622358;54173259;33279181;0;20894078;5908509;0;453093;6417441;33498043;11235712;22262331;
6439;830024043;2019-12-31;2018;MILES;200800542;172055188;28745354;30853552;0;-2108198;7089995;0;4372960;4981973;211458373;105757042;105701331;
6440;890504378;2019-12-31;2019;MILES;16788424;2655812;14132612;8332406;5227228;572978;103629;968556;710155;538572;824926;885589;-60663;
6441;890504378;2019-12-31;2018;MILES;16036988;2510879;13526109;8180979;4679639;665491;68792;840496;377201;601832;788796;297423;491373;
6442;800128867;2019-12-31;2019;MILES;25805518;15833257;9972261;2224427;7423741;324093;1304686;0;38085;279263;824529;363254;461275;
6443;800128867;2019-12-31;2018;MILES;26075422;15661737;10413685;3009492;7228012;176181;1519604;0;30637;124112;-243906;46707;-290613;
6444;800141770;2019-12-31;2019;MILES;541459918;514741849;26718069;11688063;0;15030006;13729179;3833578;13054135;3613609;14172771;6245492;7927279;
6445;800141770;2019-12-31;2018;MILES;783745552;751254662;32490890;10417944;0;22072946;16944086;3127021;9318675;1847123;13066319;5064521;8001798;
6446;830514755;2019-12-31;2019;MILES;27484945;21884004;5600941;9982457;0;-4381516;0;0;154094;656;39881835;1128225;38753610;
6447;830514755;2019-12-31;2018;MILES;30379346;20463274;9916072;9310305;0;605767;0;1976;154528;0;31419960;299895;31120065;
6448;800002942;2019-12-31;2019;MILES;77676338;62278644;15397694;6005307;3635600;5756787;2629464;309265;1204574;2489862;6512494;2205760;4306734;
6449;800002942;2019-12-31;2018;MILES;60892898;41462443;19430455;7336651;3756057;8337747;752206;2519394;539984;205481;5811612;2550714;3260898;
6450;900330644;2019-12-31;2019;MILES;0;0;0;1763;0;-1763;0;10203;0;329797;419862;2158;417704;
6451;900330644;2019-12-31;2018;MILES;0;0;0;1565;0;-1565;0;705521;0;478936;2009791;2840;2006951;
6452;900192242;2019-12-31;2019;MILES;694519700;664565533;29954167;19297430;0;10656737;14652652;0;25282332;0;315894596;7658505;308236091;
6453;900192242;2019-12-31;2018;MILES;498604280;431242539;67361741;21200338;0;46161403;9055008;0;24218696;0;446112996;35768341;410344655;
6454;830008146;2019-12-31;2019;MILES;96789989;79853695;16936294;10431575;12938562;-6433843;3949392;1889366;0;4853619;-7418982;1036023;-8455005;
6455;830008146;2019-12-31;2018;MILES;72744935;61108335;11636600;8865031;9953338;-7181769;5262343;0;0;4917445;-7526667;83469;-7610136;
6456;809002625;2019-12-31;2019;MILES;169030883;138459730;30571153;26734817;581389;3254947;3831260;791735;2545086;4994426;6171464;2083553;4087911;
6457;809002625;2019-12-31;2018;MILES;157889218;126993968;30895250;25555428;574423;4765399;3366640;1180366;1651997;6018963;7889353;3404712;4484641;
6458;800035776;2019-12-31;2019;MILES;802145952;736613864;65532088;12660357;13909844;38961887;2546785;101498426;1846411;95566384;31294274;11593417;19700857;
6459;800035776;2019-12-31;2018;MILES;666556763;592433263;74123500;10919542;13147605;50056353;2043933;87143820;1571208;57222053;21050246;8169510;12880736;
6460;890212254;2019-12-31;2019;MILES;9949305;9246150;703155;1385502;701919;-1384266;0;2620382;0;696164;-3308484;260112;-3568596;
6461;890212254;2019-12-31;2018;MILES;10128236;7249210;2879026;1711832;456768;710426;0;2427455;0;2601605;884576;421494;463082;
6462;890923937;2019-12-31;2019;MILES;111330041;67846288;43483753;13222347;5703050;24558356;5662170;551913;0;4223501;22567774;9515750;13052024;
6463;890923937;2019-12-31;2018;MILES;85919099;61433534;24485565;6285251;5990430;12209884;3914457;446903;0;4128804;11977328;4516583;7460745;
6464;860034551;2019-12-31;2019;MILES;32465802;27268419;5197383;2130034;0;3067349;353061;1203604;442135;433714;2386533;374650;2011883;
6465;860034551;2019-12-31;2018;MILES;42498425;40836190;1662235;1819165;0;-156930;3995753;15724205;981998;597676;-18297214;143585;-18440799;
6466;890902070;2019-12-31;2019;MILES;382648422;366732208;15916214;16050639;0;-134425;20823972;836400;19981162;4774611;1155693;828815;326878;
6467;890902070;2019-12-31;2018;MILES;1259728734;1223247875;36480859;10627513;0;25853346;31182811;2377912;30608665;2633271;25534559;10542166;14992393;
6468;860063869;2019-12-31;2019;MILES;102965025;84449821;18515204;11299655;0;7215549;1087202;0;0;0;3086178;1797045;1289133;
6469;860063869;2019-12-31;2018;MILES;101458661;85813097;15645564;10395790;0;5249774;1474647;0;0;0;5594975;2250000;3344975;
6470;805013653;2019-12-31;2019;MILES;11256809;399165;10857644;1851411;4790710;4215523;2121732;32695;64327;2787847;10810364;356972;10453392;
6471;805013653;2019-12-31;2018;MILES;10671516;327647;10343869;2751851;5402679;2189339;2277237;163614;83128;4521918;7105980;-1373131;8479111;
6472;890908649;2019-12-31;2019;MILES;191168596;151021282;40147314;25360718;7416115;7370481;5283611;0;139787;0;5853716;1205830;4647886;
6473;890908649;2019-12-31;2018;MILES;179107262;140064753;39042509;33442441;0;5600068;4984021;908749;122916;0;1067139;-1078873;2146012;
6474;830003460;2019-12-31;2019;MILES;7027565;5058370;1969195;922322;0;1046873;490354;20027;5354;32880;618796;116047;502749;
6475;830003460;2019-12-31;2018;MILES;8178515;6198101;1980414;1034344;0;946070;683652;21555;39;383608;670743;230903;439840;
6476;800149392;2019-12-31;2019;MILES;8729943;2481875;6248068;501850;148837;5597381;1430;611659;512966;138;5497365;532600;4964765;
6477;800149392;2019-12-31;2018;MILES;8719810;2318352;6401458;455430;133153;5812875;530;155603;437622;4100;6098401;765358;5333043;
6478;900276962;2019-12-31;2019;MILES;4969299066;4201957923;767341143;246828803;471267119;49245221;105091704;2868153;12099923;13816306;-32798407;3929319;-36727726;
6479;900276962;2019-12-31;2018;MILES;3792778211;3260452685;532325526;188542665;369579712;-25796851;29498832;4212889;8600037;18706646;-32201889;-7090294;-25111595;
6480;821000169;2019-12-31;2019;MILES;60494130;42604108;17890022;2850198;5210555;9829269;1023742;130028;1185114;382939;13605091;3108787;10496304;
6481;821000169;2019-12-31;2018;MILES;55928396;40542052;15386344;3256470;5460908;6668966;962657;371021;1013434;852847;12771606;1919316;10852290;
6482;860001965;2019-12-31;2019;MILES;284046406;186654166;97392240;26766928;67426253;3199059;1436819;5388873;1394028;11343524;14932938;7138878;7794060;
6483;860001965;2019-12-31;2018;MILES;257369523;161390823;95978700;25694002;62781314;7503384;1637767;5284329;1625725;8540900;10747913;3881826;6866087;
6484;890913952;2019-12-31;2019;MILES;30335368;23688111;6647257;3356956;0;3290301;415223;234998;503578;0;3297876;877693;2420183;
6485;890913952;2019-12-31;2018;MILES;33346863;26493642;6853221;6044030;0;809191;822955;253215;583694;0;967144;279489;687655;
6486;860513857;2019-12-31;2019;MILES;76192533;33417201;42775332;1401084;0;41374248;1255775;3908783;0;493610;36703300;3773610;32929690;
6487;860513857;2019-12-31;2018;MILES;145024137;33074160;111949977;993198;0;110956779;900444;450281;0;196330;114039231;14819872;99219359;
6488;860522056;2019-12-31;2019;MILES;191243789;152180480;39063309;12648933;25876451;537925;9273618;9500479;431658;5745093;-12059421;723298;-12782719;
6489;860522056;2019-12-31;2018;MILES;212953380;163756207;49197173;11485723;26324461;11386989;13718257;20969540;4342106;26506638;9874791;5478072;4396719;
6490;830500354;2019-12-31;2019;MILES;16997365;15107491;1889874;1217847;944314;-272287;1014374;1738413;0;1147839;-1877235;0;-2055055;
6491;830500354;2019-12-31;2018;MILES;16295263;13414100;2881163;1375652;818219;687292;1116313;155645;0;527987;-56679;0;-91640;
6492;800233881;2019-12-31;2019;MILES;310520216;267496492;43023724;11718514;0;31305210;12654685;5246931;344057;15256147;28560461;4996686;23563775;
6493;800233881;2019-12-31;2018;MILES;269658150;240643272;29014878;12609981;0;16404897;13850368;3437772;1546368;10663515;11316482;-1396983;12713465;
6494;860060256;2019-12-31;2019;MILES;271310;0;271310;200632;6451;64227;7482;137095;8584;254083;849722;665156;184566;
6495;860060256;2019-12-31;2018;MILES;811666;0;811666;423529;7629;380508;8992;659347;3724;218660;195800;-588638;784438;
6496;900323853;2019-12-31;2019;MILES;862365978;588217870;274148108;168570120;0;105577988;38021861;4370223;0;30037328;95255629;26663238;68592391;
6497;900323853;2019-12-31;2018;MILES;550258366;383913146;166345220;114795165;0;51550055;13299001;4935546;0;28897455;66041248;19373582;46667666;
6498;860028462;2019-12-31;2019;MILES;75643392;6317402;69325990;56840932;0;12485058;0;4367808;0;700973;8818223;3743420;5074803;
6499;860028462;2019-12-31;2018;MILES;67176109;8315991;58860118;49485654;0;9374464;0;4744849;0;2657995;7287610;2767378;4520232;
6500;800184269;2019-12-31;2019;MILES;96574094;81290084;15284010;2575889;5871063;6837058;2000992;321568;1788106;0;6302604;1963603;4339001;
6501;800184269;2019-12-31;2018;MILES;88311660;76131844;12179816;2562208;5354414;4263194;1531592;1325049;545908;0;1952461;582352;1370109;
6502;900015051;2019-12-31;2019;MILES;266596510;233918928;32677582;22483135;12335820;-2141373;17517325;2493816;477337;2493436;-19069385;-4386241;-14683144;
6503;900015051;2019-12-31;2018;MILES;275455131;235080626;40374505;25847995;11829351;2697159;16283313;2739294;355374;7563762;3160316;-5137050;8297366;
6504;900239552;2019-12-31;2019;MILES;13651172;11023289;2627883;2372536;0;255347;126689;0;19800;0;148458;103718;44740;
6505;900239552;2019-12-31;2018;MILES;11105689;8753546;2352143;2132959;0;219184;203042;0;125169;0;141311;79520;61791;
6506;891304762;2019-12-31;2019;MILES;996869454;886884872;109984582;11511050;48853002;49620530;10386140;1082964;0;11401658;49553084;13612791;35940293;
6507;891304762;2019-12-31;2018;MILES;897192280;809643035;87549245;11410333;29073858;47065054;199412;6551937;0;3112784;43426489;15343522;28082967;
6508;830126461;2019-12-31;2019;MILES;29953677;1585904;28367773;18867241;0;9500532;3305173;547496;28182;164079;5704337;2309049;3395288;
6509;830126461;2019-12-31;2018;MILES;25401510;3950291;21451219;14841683;0;6609536;2542909;369358;16928;366306;3722670;1295738;2426932;
6510;900606148;2019-12-31;2019;MILES;0;0;0;29381;0;-29381;3907;345;5270;0;-272756166;120;-272756286;
6511;900606148;2019-12-31;2018;MILES;0;0;0;95297;0;-95297;3282;1775;5638;0;-449222;92;-449314;
6512;890312652;2019-12-31;2019;MILES;18740148;10794859;7945289;758165;2533677;4653447;2896426;285469;2553471;411192;6811664;1428168;5383496;
6513;890312652;2019-12-31;2018;MILES;17021290;10250205;6771085;672896;1825311;4272878;1065856;170323;887656;121689;6328851;1285764;5043087;
6514;860525156;2019-12-31;2019;MILES;29494755;17375190;12119565;3049520;1665414;7404631;2159652;0;0;0;4076225;14076;4062149;
6515;860525156;2019-12-31;2018;MILES;36783258;26850893;9932365;2387229;2114190;5430946;2479601;680504;294508;1660077;3926160;2147988;1778172;
6516;900325551;2019-12-31;2019;MILES;21527564;19784199;1743365;13695;11404;1718266;0;331155;0;348837;1735948;316261;1419687;
6517;900325551;2019-12-31;2018;MILES;6735792;4599898;2135894;751583;163512;1220799;0;444025;0;182797;959571;128011;831560;
6518;860350253;2019-12-31;2019;MILES;170181151;52471491;117709660;11078763;89198560;17432337;15220372;4628098;2795596;3688584;4068047;6815220;-2747173;
6519;860350253;2019-12-31;2018;MILES;151809682;46250485;105559197;10837636;81445494;13276067;12254827;2093374;1425211;3706216;4059293;-1240486;5299779;
6520;811039652;2019-12-31;2019;MILES;18758772;7631055;11127717;3694534;9004326;-1571143;4395679;729243;3030850;3089679;-575536;-10859;-564677;
6521;811039652;2019-12-31;2018;MILES;19738598;6709616;13028982;5673895;8504135;-1149048;3225063;3473169;1472511;841165;-5533604;-38217;-5495387;
6522;805030849;2019-12-31;2019;MILES;27429388;11149190;16280198;6275113;726878;9278207;1803070;5765382;342085;1430064;3481904;226856;3255048;
6523;805030849;2019-12-31;2018;MILES;89979550;68678971;21300579;5314395;1775278;14210906;2853334;3151479;811760;1982813;11000666;831469;10169197;
6524;860032550;2019-12-31;2019;MILES;372759292;244191391;128567901;19163462;134280820;-24876381;11610368;4571083;2211879;10791681;-30043522;-438044;-29605478;
6525;860032550;2019-12-31;2018;MILES;363827279;238738899;125088380;20973895;132027156;-27912671;10953061;2304001;2092375;4211470;-39318034;-549323;-38768711;
6526;901222456;2019-12-31;2019;MILES;0;0;0;2029;0;-2029;2284838;0;2284838;0;-2029;98225;-100254;
6527;901222456;2019-12-31;2018;MILES;22204032;0;22204032;164078;0;22039954;0;0;0;0;22039954;0;22039954;
6528;860020058;2019-12-31;2019;MILES;553355523;483721936;69633587;8553657;46471316;14608614;3967842;0;1493950;0;24207009;8317649;15889360;
6529;860020058;2019-12-31;2018;MILES;452338640;395564567;56774073;8549879;36705460;11518734;3199143;0;416259;0;20507092;7955263;12551829;
6530;860015067;2019-12-31;2019;MILES;10001779;9035260;966519;622728;0;343791;0;0;0;0;375679;311499;64180;
6531;860015067;2019-12-31;2018;MILES;8492608;6766336;1726272;529361;0;1196911;339201;594317;0;29278;292671;691912;-399241;
6532;900313659;2019-12-31;2019;MILES;3065522;2230377;835145;612006;0;223139;0;375787;0;1320574;1167926;43278;1124648;
6533;900313659;2019-12-31;2018;MILES;3245250;1920567;1324683;884300;0;440383;0;288038;0;605931;758276;219237;539039;
6534;811028650;2019-12-31;2019;MILES;518400171;299853086;218547085;11312624;29513084;177721377;3859124;133062831;390542;2464166;45718235;14639697;31078538;
6535;811028650;2019-12-31;2018;MILES;480289578;281989204;198300374;10757957;23882309;163660108;3387031;126084295;300682;2365212;39877950;13396758;26481192;
6536;890921972;2019-12-31;2019;MILES;45054198;0;45054198;1102484;0;43951714;206416;39179;0;0;43705763;405788;43299975;
6537;890921972;2019-12-31;2018;MILES;32254218;0;32254218;1117741;0;31136477;69533;0;0;0;7322447;716800;6605647;
6538;860527960;2019-12-31;2019;MILES;97318506;78894968;18423538;4860467;8631450;4931621;2553110;100512;6943615;1039816;10261430;2505447;7755983;
6539;860527960;2019-12-31;2018;MILES;84634525;69653945;14980580;3862380;7333269;3784931;6327632;62927;2869085;925359;1188816;80245;1108571;
6540;900637750;2019-12-31;2019;MILES;2623451;2623503;-52;0;2215;-2267;46;477;1704;0;-1086;754;-1840;
6541;900637750;2019-12-31;2018;MILES;0;0;0;0;4207;-4207;0;0;5076;0;869;74332;-73463;
6542;860025054;2019-12-31;2019;MILES;32543380;19609826;12933554;703393;0;12230161;5070252;2183268;0;1343834;6320475;2028956;4291519;
6543;860025054;2019-12-31;2018;MILES;53885710;43573896;10311814;940103;0;9371711;167974;1062398;0;8436852;16578191;5596661;10981530;
6544;900425482;2019-12-31;2019;MILES;0;0;0;596763;0;-596763;16088271;0;0;0;-20639594;209;-20639803;
6545;900425482;2019-12-31;2018;MILES;0;0;0;1077133;0;-1077133;7862290;0;0;0;-17799356;32884;-17832240;
6546;900111454;2019-12-31;2019;MILES;43461366;0;43461366;12264683;0;31196683;57244861;1340405;32638382;9412762;69906712;491554;69415158;
6547;900111454;2019-12-31;2018;MILES;30207551;0;30207551;9303777;0;20903774;51289336;15834361;14800306;2417852;-25743663;1394193;-27137856;
6548;900285692;2019-12-31;2019;MILES;0;0;0;5007;0;-5007;25061389;4194703;31130798;590983;2460682;182761;2277921;
6549;900285692;2019-12-31;2018;MILES;0;0;0;30696;0;-30696;17590997;3542192;21927876;27840;791831;507;791324;
6550;860069163;2019-12-31;2019;MILES;10634883;0;10634883;1191147;0;9443736;1449656;290685;342578;9354;8055327;863936;7191391;
6551;860069163;2019-12-31;2018;MILES;16762273;0;16762273;2712798;0;14049475;2624672;55976;2739378;261712;14369917;695747;13674170;
6552;890907163;2019-12-31;2019;MILES;375862135;343037367;32824768;7851815;11115332;13857621;14666950;496000;3194481;2072174;4795377;875440;3919937;
6553;890907163;2019-12-31;2018;MILES;326016390;302364262;23652128;6971222;10133770;6547136;11482293;60907;2994709;2687968;1141148;990133;151015;
6554;890316056;2019-12-31;2019;MILES;3812503;16846;3795657;845615;0;2950042;29872;264474;324677;352996;3333369;801021;2532348;
6555;890316056;2019-12-31;2018;MILES;7665877;15871;7650006;1116493;0;6533513;1610045;77857;1040213;1868463;7754287;336324;7417963;
6556;800232359;2019-12-31;2019;MILES;59014212;36469632;22544580;16105042;0;6439538;0;4734848;0;3186370;3970838;1196711;2774127;
6557;800232359;2019-12-31;2018;MILES;52436290;29929332;22506958;17159016;0;5347942;0;0;0;3154736;6512742;906670;5606072;
6558;800033159;2019-12-31;2019;MILES;119441801;108090734;11351067;12913889;8399903;-9962725;1677131;129750;0;0;-11769606;14133066;-25902672;
6559;800033159;2019-12-31;2018;MILES;112138506;97868754;14269752;11175180;6907085;-3812513;14365582;3763634;7240068;0;-14701661;-371353;-14330308;
6560;810001350;2019-12-31;2019;MILES;13648622;12887980;760642;1407124;5044136;-5690618;1370913;509948;229635;2569701;-4772143;0;-4772143;
6561;810001350;2019-12-31;2018;MILES;14651746;11931705;2720041;1576192;7150579;-6006730;939298;2471974;0;4983646;-4434356;0;-4434356;
6562;860522754;2019-12-31;2019;MILES;4184463;2639620;1544843;2063867;112262;-631286;4944130;1853756;5754356;1843592;12402498;514547;11887951;
6563;860522754;2019-12-31;2018;MILES;4046381;2831687;1214694;2669224;75790;-1530320;2231477;675323;12853879;6332494;26588112;1637662;24950450;
6564;860050753;2019-12-31;2019;MILES;22008018;19366770;2641248;1144352;5162470;-3665574;3310031;8299905;1309694;2548829;-11416987;-1210551;-10206436;
6565;860050753;2019-12-31;2018;MILES;30179888;25725841;4454047;1649644;7458384;-4653981;3836661;99987;713117;189615;-7687897;25619;-7713516;
6566;900570964;2019-12-31;2019;MILES;377477645;307031657;70445988;20862310;39870351;9713327;33557095;0;20295120;8322607;4764283;2570250;2194033;
6567;900570964;2019-12-31;2018;MILES;304577986;257634050;46943936;19640930;30050303;-2747297;34216442;34216442;14749608;5856073;-50574500;4263544;-12202604;
6568;800188557;2019-12-31;2019;MILES;51183293;40914365;10268928;3816065;285057;6167806;0;0;0;0;5687350;2961119;2726231;
6569;800188557;2019-12-31;2018;MILES;10920522;4248133;6672389;2388724;231595;4052070;0;411185;0;258542;3722704;1268588;2454116;
6570;890401958;2019-12-31;2019;MILES;86801751;81847776;4953975;87246;0;4866729;133387;196733;271;110958;4644450;1807841;2836609;
6571;890401958;2019-12-31;2018;MILES;95840520;92286050;3554470;176026;0;3378444;39007;54543;145;70790;3355829;1376497;1979332;
6572;860511458;2019-12-31;2019;MILES;309549988;252984817;56565171;9715571;18378499;28471101;5869230;20431543;2052684;1785840;5631655;392705;5238950;
6573;860511458;2019-12-31;2018;MILES;253488619;209718387;43770232;7298354;20226894;16244984;0;6423140;0;697637;10519481;4435417;6084064;
6574;900619863;2019-12-31;2019;MILES;150135704;142518922;7616782;10933725;0;-3316943;1961908;107655;317370;123352;10596593;4807524;5789069;
6575;900619863;2019-12-31;2018;MILES;106797664;102118257;4679407;9824770;0;-5145363;1614571;624052;647119;403814;-1657530;942899;-2600429;
6576;860050956;2019-12-31;2019;MILES;36048416;28792315;7256101;2377423;4403192;475486;1003513;54148;48952;522749;-10474;55486;-65960;
6577;860050956;2019-12-31;2018;MILES;37450435;30663434;6787001;2357668;4533365;-104032;1105249;45588;39710;192022;-1023137;155233;-1178370;
6578;900386657;2019-12-31;2019;MILES;0;0;0;24302;0;-24302;7;8;0;0;-24317;7085;-31402;
6579;900386657;2019-12-31;2018;MILES;0;0;0;57816;0;-57816;25426;3125;518;0;-85849;-6744;-79105;
6580;900043170;2019-12-31;2019;MILES;111598539;97477103;14121436;3259417;2716663;8145356;2753021;0;1302412;2694;6969380;2683408;4285972;
6581;900043170;2019-12-31;2018;MILES;90754086;81202068;9552018;2323114;1732973;5495931;1619687;0;289199;231;3803819;1554382;2249437;
6582;860047657;2019-12-31;2019;MILES;577171443;498273468;78897975;8981375;71909916;-1993316;9527734;4451125;0;0;-18514249;-4256817;-14257432;
6583;860047657;2019-12-31;2018;MILES;468280346;387370957;80909389;7041122;63544898;10323369;2528842;1340279;898071;0;12506719;4633732;7872987;
6584;817002753;2019-12-31;2019;MILES;241710305;192856140;48854165;5500458;0;43353707;1377695;47215619;0;0;-8794043;3534048;-12328091;
6585;817002753;2019-12-31;2018;MILES;228126637;166764847;61361790;4612865;0;56748925;434291;71157434;0;0;-18312773;-3584081;-14728692;
6586;900203461;2019-12-31;2019;MILES;542141524;476535557;65605967;14437943;1036533;50131491;14563712;612679;2779990;4458976;43879120;12785376;31093744;
6587;900203461;2019-12-31;2018;MILES;610788795;540510160;70278635;22173067;696529;47409039;14489729;2455570;5155899;2072877;38119841;11423414;26696427;
6588;900265156;2019-12-31;2019;MILES;14605783;0;14605783;2919019;0;11686764;338314;115675;361807;73830;11668412;70291;11598121;
6589;900265156;2019-12-31;2018;MILES;11782756;0;11782756;3177413;0;8605343;292982;43312;491656;676781;9437486;336090;9101396;
6590;890206351;2019-12-31;2019;MILES;106658786;48543749;58115037;19334618;1125829;37654590;1352500;2704644;2685680;9955416;46238542;15518124;30720418;
6591;890206351;2019-12-31;2018;MILES;115688492;47960530;67727962;18141119;11269940;38316903;529775;2642827;2623965;2734773;40503039;14988723;25514316;
6592;900061554;2019-12-31;2019;MILES;103725810;0;103725810;801656;0;102924154;0;220042612;0;162322598;45204140;50227;45153913;
6593;900061554;2019-12-31;2018;MILES;3063492899;0;3063492899;24865052;0;3038627847;0;9196008;0;12393002;3041824841;8582;3041816259;
6594;805025355;2019-12-31;2019;MILES;10527294;5808224;4719070;2845208;600178;1273684;31606;127578;84339;2722;1205869;432621;773248;
6595;805025355;2019-12-31;2018;MILES;7829623;5003729;2825894;1694628;763335;367931;27126;80841;52776;67150;717005;228729;488276;
6596;800204462;2019-12-31;2019;MILES;57589225;39064887;18524338;10628467;0;7895871;0;2244728;3488616;758144;25460277;11703805;13756472;
6597;800204462;2019-12-31;2018;MILES;164029410;109899795;54129615;22520772;0;31608843;0;4563665;3862803;1198801;37329415;-4558039;41887454;
6598;811046960;2019-12-31;2019;MILES;20513430;13883604;6629826;1793449;0;4836377;5300510;1452179;3212010;2018836;3314534;-1612645;4927179;
6599;811046960;2019-12-31;2018;MILES;15525170;10529142;4996028;1920678;0;3075350;4980337;2121419;175249;9609894;5758737;957716;4801021;
6600;830092963;2019-12-31;2019;MILES;342350383;257232096;85118287;14153118;16503798;54461371;7094818;43516868;6830584;43887413;54404306;15790590;38613716;
6601;830092963;2019-12-31;2018;MILES;202719982;161358752;41361230;10340793;11315670;19704767;5168019;23154099;6949647;21920560;20607840;6247093;14360747;
6602;900149460;2019-12-31;2019;MILES;72579267;63414246;9165021;3268376;3196741;2699904;0;1634242;74711;0;1291499;927224;364275;
6603;900149460;2019-12-31;2018;MILES;71359079;64954491;6404588;4432068;3363528;-1391008;680294;1410514;0;0;2769841;-93065;2862906;
6604;800198989;2019-12-31;2019;MILES;1245379;0;1245379;780971;0;464408;361513;546;309739;233;412321;-340136;752457;
6605;800198989;2019-12-31;2018;MILES;1105431;0;1105431;940920;0;164511;394581;2594;82292;1014230;863858;652224;211634;
6606;900612364;2019-12-31;2019;MILES;10519615;8944864;1574751;353843;0;1220908;329121;0;0;0;891787;1013181;-121394;
6607;900612364;2019-12-31;2018;MILES;16736701;14200127;2536574;260992;0;2275582;300035;0;0;0;1975547;1632409;343138;
6608;900488297;2019-12-31;2019;MILES;57923999;42963137;14960862;19893919;3627129;-8560186;1374023;0;0;0;-9934209;279803;-10214012;
6609;900488297;2019-12-31;2018;MILES;48386891;34577050;13809841;21877805;3245660;-11313624;1722091;0;0;0;-13035715;427899;-13463614;
6610;800070965;2019-12-31;2019;MILES;0;0;0;1001724;0;-1001724;8577;51387;156739;6284842;28062564;3329161;24733403;
6611;800070965;2019-12-31;2018;MILES;0;0;0;951143;0;-951143;0;21970;65325;5706230;27671762;4429859;23241903;
6612;800149296;2019-12-31;2019;MILES;3419755;0;3419755;2467922;0;951833;3775;33326;250;37602;13065454;250184;12815270;
6613;800149296;2019-12-31;2018;MILES;3278817;0;3278817;2163869;0;1114948;4568;73343;3841;67920;10012103;-130247;10142350;
6614;900213087;2019-12-31;2019;MILES;8116198;6660926;1455272;920439;0;534833;927360;261519;159487;5905;-488654;0;-491416;
6615;900213087;2019-12-31;2018;MILES;9841493;8142679;1698814;1016392;0;682422;567680;33193;134300;35093;250942;0;222360;
6616;900854661;2019-12-31;2019;MILES;2259620;0;2259620;1302224;0;957396;802809;1250;0;1318707;291451;-284955;576406;
6617;900854661;2019-12-31;2018;MILES;1227180;0;1227180;1491800;0;-264620;638;4213;0;2505589;7521115;76467;7444648;
6618;890105365;2019-12-31;2019;MILES;18939254;16055718;2883536;942359;841047;1100130;4041;487984;168505;884200;3129851;486003;2643848;
6619;890105365;2019-12-31;2018;MILES;18018718;15049798;2968920;850377;830293;1288250;3000;89580;151001;809068;2355196;94774;2260422;
6620;830035263;2019-12-31;2019;MILES;60188258;42206078;17982180;11786311;16264439;-10068570;0;0;0;50868;-11990353;1380881;-13371234;
6621;830035263;2019-12-31;2018;MILES;42167692;29642979;12524713;8449424;20771921;-16696632;0;409314;0;0;-32151067;-1714095;-30436972;
6622;890301463;2019-12-31;2019;MILES;897444310;508866502;388577808;61984151;247848948;78744709;2437066;51584010;897818;0;54403335;16255242;38148093;
6623;890301463;2019-12-31;2018;MILES;878600703;492723350;385877353;47461523;237507170;100908660;242846;46255323;615077;16560021;75486576;24668256;50818320;
6624;811008963;2019-12-31;2019;MILES;505576444;453024386;52552058;0;0;52552058;10076733;0;1426003;0;65001818;15074947;49926871;
6625;811008963;2019-12-31;2018;MILES;459089390;410984912;48104478;0;0;48104478;8220622;0;16552329;0;56436185;17644244;38791941;
6626;800020762;2019-12-31;2019;MILES;246825771;0;246825771;15283105;0;231542666;783;1;16371125;139607;248052614;437715;247614899;
6627;800020762;2019-12-31;2018;MILES;224987131;0;224987131;290723;0;224696408;429;110;690801;49;225386719;228970;225157749;
6628;804002861;2019-12-31;2019;MILES;5079650;0;5079650;4198455;0;881195;1372122;371858;918631;670773;726619;431240;295379;
6629;804002861;2019-12-31;2018;MILES;4417816;0;4417816;3504901;0;912915;1992608;14298;486762;1031642;424413;206293;218120;
6630;901291264;2019-12-31;2019;MILES;0;0;0;0;0;0;8233810;61594384;3258555;0;-66569639;0;-66569639;
6631;901291264;2019-12-31;2018;MILES;0;0;0;0;0;0;0;0;0;0;0;0;0;ERR valores en cero
6632;900265163;2019-12-31;2019;MILES;246329256;0;246329256;15220527;0;231108729;817;1;16477320;81207;247666438;452388;247214050;
6633;900265163;2019-12-31;2018;MILES;224517689;0;224517689;269244;0;224248445;408;0;677443;749;224926229;165000;224761229;
6634;900061364;2019-12-31;2019;MILES;1866644;1120577;746067;840755;66844;-161532;143696;9599;3461;1300136;988770;47750;941020;
6635;900061364;2019-12-31;2018;MILES;10163304;8153271;2010033;634328;10225;1365480;132281;266695;27792;678403;1672699;168031;1504668;
6636;800094968;2019-12-31;2019;MILES;600005614;417356852;182648762;18493751;35629343;128525668;12465592;10753320;3184417;1361141;109852314;21803799;88048515;
6637;800094968;2019-12-31;2018;MILES;459070939;330514487;128556452;12881079;28805712;86869661;13390330;4877279;4438953;1049107;74090112;19141892;54948220;
6638;860001963;2019-12-31;2019;MILES;180011078;132321120;47689958;19665822;17381875;10642261;8490412;0;1073172;0;4359435;243710;4115725;
6639;860001963;2019-12-31;2018;MILES;166810967;125673322;41137645;16029167;16302717;8805761;9891306;0;499629;0;590013;1129418;-539405;
6640;890917465;2019-12-31;2019;MILES;161608793;99881818;61726975;24531698;19616804;17578473;0;654596;457769;1016525;18431375;6246280;12185095;
6641;890917465;2019-12-31;2018;MILES;141884874;89833860;52051014;21172192;16907171;13971651;144803;629224;0;516050;13755127;6658462;7096665;
6642;890306162;2019-12-31;2019;MILES;31801073;10266759;21534314;21269478;418528;-153692;0;1826711;0;4655669;2675266;1279811;1395455;
6643;890306162;2019-12-31;2018;MILES;34418097;12384153;22033944;22433724;512782;-912562;0;1069101;0;3890082;1908419;2504668;-596249;
6644;900595161;2019-12-31;2019;MILES;11347778;0;11347778;21388660;0;-10040882;2966787;0;23292952;264218;61814418;3116206;58698212;
6645;900595161;2019-12-31;2018;MILES;19755000;0;19755000;19562596;0;192404;1330583;0;17513779;72880;63595999;4566678;59029321;
6646;900454277;2019-12-31;2019;MILES;1633;0;1633;66200;0;-64567;0;3028698;0;2;18446712;650222;17796490;
6647;900454277;2019-12-31;2018;MILES;103;0;103;121591;0;-121488;0;2737916;0;0;10383770;0;10383770;
6648;800114672;2019-12-31;2019;MILES;66804321;47896378;18907943;4892688;5301424;8713831;0;628732;137397;1585459;10041276;3169958;6871318;
6649;800114672;2019-12-31;2018;MILES;70056349;48616529;21439820;6239514;5060338;10139968;0;373794;121081;1089803;11233870;3891117;7342753;
6650;830021260;2019-12-31;2019;MILES;20128825;8900593;11228232;2995490;6182145;2050597;1064015;0;237488;0;1224070;436730;787340;
6651;830021260;2019-12-31;2018;MILES;17941659;8583195;9358464;2674916;5315490;1368058;434425;0;279667;0;1213300;448035;765265;
6652;800190665;2019-12-31;2019;MILES;99749483;85648828;14100655;2556756;6880028;4663871;5560011;1611130;2834909;1989214;2325614;848871;1476743;
6653;800190665;2019-12-31;2018;MILES;86798574;76269716;10528858;2497587;5362879;2668392;5371899;677375;1968842;2453680;798224;22838;775386;
6654;830140271;2019-12-31;2019;MILES;5891144;2474046;3417098;2166364;0;1250734;46284485;2668602;6509088;23321;-20828303;-1118537;-19709766;
6655;830140271;2019-12-31;2018;MILES;5181032;2800668;2380364;3520430;0;-1140066;32335569;351753;143039;52752;-38243925;-705842;-37538083;
6656;860001771;2019-12-31;2019;MILES;27717959;20148565;7569394;4849087;7186346;-4466039;2323570;614247;1771504;12788470;7156118;2518;7153600;
6657;860001771;2019-12-31;2018;MILES;26450640;19478897;6971743;3907300;3579968;-515525;3800687;267063;882911;1062034;-2638330;214833;-2853163;
6658;900442475;2019-12-31;2019;MILES;340678;0;340678;318749;0;21929;180334;22593;563;2927484;-60434740;-3115529;-57319211;
6659;900442475;2019-12-31;2018;MILES;316910;0;316910;1104429;0;-787519;197198;9;317223;14870301;14202798;-21729150;35931948;
6660;800239064;2019-12-31;2019;MILES;174607457;134905026;39702431;4013594;28833919;6854918;10671460;606488;9298617;1772061;6647648;2397512;4250136;
6661;800239064;2019-12-31;2018;MILES;155001799;120168671;34833128;3369009;24887002;6577117;6279299;871180;3855905;2224616;5507159;2083889;3423270;
6662;900966969;2019-12-31;2019;MILES;17113196;12589467;4523729;1850578;1880490;792661;4994412;338874;1415318;47010;-2958118;-90289;-2867829;
6663;900966969;2019-12-31;2018;MILES;10438705;8211584;2227121;2070966;1251058;-1094903;2304416;0;943982;66331;-4340826;-1178182;-3162644;
6664;805001285;2019-12-31;2019;MILES;2895321;0;2895321;1267052;898225;730044;8397;2881070;200300;2743;-2251699;271280;-2522979;
6665;805001285;2019-12-31;2018;MILES;2918312;0;2918312;1163752;761819;992741;8387;23012;219903;37186;1010315;272354;737961;
6666;860007668;2019-12-31;2019;MILES;207938112;176311338;31626774;11524606;4451541;15650627;13582331;119920;9802529;100208;11522382;3570523;7951859;
6667;860007668;2019-12-31;2018;MILES;202090988;172439332;29651656;13383145;4309893;11958618;18092279;221274;10128901;165050;3640095;2635844;1004251;
6668;860016767;2019-12-31;2019;MILES;54318291;42368124;11950167;3075653;6954087;1920427;1253549;195817;0;1379377;6663070;981635;5681435;
6669;860016767;2019-12-31;2018;MILES;46031889;34947021;11084868;2868228;6108566;2108074;1281110;150331;0;1201555;5992280;1193471;4798809;
6670;890301868;2019-12-31;2019;MILES;82593701;72719296;9874405;2855806;6238665;779934;0;2861556;0;6405524;4323902;334731;3989171;
6671;890301868;2019-12-31;2018;MILES;75624814;63361311;12263503;2402020;6132444;3729039;0;3663191;0;5442898;5508746;1031059;4477687;
6672;860070770;2019-12-31;2019;MILES;14857257;7783440;7073817;1558964;4350334;1164519;1227105;102024;84816;335133;255339;1427075;-1171736;
6673;860070770;2019-12-31;2018;MILES;16731658;9768735;6962923;1485866;4826779;650278;1857325;89711;308193;126420;-862145;425718;-1287863;
6674;890900267;2019-12-31;2019;MILES;106408860;55549969;50858891;14377429;20500482;15980980;4626925;1308677;633584;0;10874018;4047934;6826084;
6675;890900267;2019-12-31;2018;MILES;93122057;55710781;37411276;13855205;17668678;5887393;7031498;1381156;2281846;552914;309499;815558;-506059;
6676;800032970;2019-12-31;2019;MILES;28666877;261522;28405355;5475328;4479415;18450612;1973618;572793;242963;199044;16346208;306836;16039372;
6677;800032970;2019-12-31;2018;MILES;11429297;0;11429297;3511503;33844;7883950;78554;12096;0;382522;8175822;-2968624;11144446;
6678;900419769;2019-12-31;2019;MILES;7125;162698;-155573;28817;0;-184390;0;34193;0;27088;-638058;-26094;-611964;
6679;900419769;2019-12-31;2018;MILES;4994;288026;-283032;128953;754;-412739;0;183308;0;192397;-1130153;-96452;-1033701;
6680;900831969;2019-12-31;2019;MILES;1731608;0;1731608;10228;0;1721380;188830;7051;264075;0;1789574;122447;1667127;
6681;900831969;2019-12-31;2018;MILES;1843893;0;1843893;12551;0;1831342;524523;25442;39767;0;1321144;-121904;1443048;
6682;890924167;2019-12-31;2019;MILES;239475634;126234757;113240877;37340441;55818911;20081525;10136046;2148605;77953;0;6298628;2291622;4007006;
6683;890924167;2019-12-31;2018;MILES;228838596;117866792;110971804;33016239;61690296;16265269;12596806;1381332;3249730;0;3737013;1963590;1773423;
6684;900479267;2019-12-31;2019;MILES;828518719;799384958;29133761;5231904;2864445;21037412;3633588;608741;201171;9144;15428699;3816159;11612540;
6685;900479267;2019-12-31;2018;MILES;547962574;529388452;18574122;5135945;2938785;10499392;2772820;118805;46019;25001;6458266;2745797;3712469;
6686;860031169;2019-12-31;2019;MILES;2542525;2000914;541611;1151853;22795;-633037;582808;756183;2442879;24130;3052628;673702;2378926;
6687;860031169;2019-12-31;2018;MILES;2357781;1588702;769079;1246838;18796;-496555;1990799;927072;3230119;178424;2130403;2587421;-457018;
6688;890922265;2019-12-31;2019;MILES;60327756;37239909;23087847;6229879;0;16857968;2280856;535247;1188005;0;15229870;5974189;9255681;
6689;890922265;2019-12-31;2018;MILES;30504755;21813808;8690947;5561996;0;3128951;836095;428879;1401260;0;3265237;1038407;2226830;
6690;800164767;2019-12-31;2019;MILES;152583875;84250366;68333509;11090589;34030481;23212439;1348845;1575283;1255269;288271;20460380;7470069;12990311;
6691;800164767;2019-12-31;2018;MILES;122733060;66340560;56392500;7253095;28414262;20725143;107874;1504251;348675;427437;19205185;8075380;11129805;
6692;805010369;2019-12-31;2019;MILES;57185019;53751466;3433553;3246333;0;187220;184666;218049;408389;789309;982203;70875;911328;
6693;805010369;2019-12-31;2018;MILES;46113395;41455666;4657729;3473985;0;1183744;74550;20276;235465;245765;1570148;461368;1108780;
6694;900265170;2019-12-31;2019;MILES;375144295;0;375144295;6722099;0;368422196;111206;4341;8983392;0;377290041;203951;377086090;
6695;900265170;2019-12-31;2018;MILES;291226944;0;291226944;9917521;0;281309423;135984;1;0;9649642;290823080;681449;290141631;
6696;901142867;2019-12-31;2019;MILES;0;0;0;29983;0;-29983;0;0;0;0;90334101;-9894;90343995;
6697;901142867;2019-12-31;2018;MILES;0;0;0;226841;0;-226841;0;29779;0;0;-256620;-74842;-181778;
6698;891855089;2019-12-31;2019;MILES;6290951;0;6290951;5845131;0;445820;1541370;22172;24221;717288;13023485;-183203;13206688;
6699;891855089;2019-12-31;2018;MILES;9180095;0;9180095;6457497;0;2722598;1380491;30421;34902;735208;7397733;762641;6635092;
6700;800027867;2019-12-31;2019;MILES;20421491;11563885;8857606;792866;3014272;5050468;0;529604;79324;959598;11940323;1807414;10132909;
6701;800027867;2019-12-31;2018;MILES;19328355;10466928;8861427;754480;2612989;5493958;0;817976;97130;1254964;11904697;1812320;10092377;
6702;900128566;2019-12-31;2019;MILES;106593609;83439116;23154493;19137837;0;4016656;3398857;334744;107956;294301;-1797973;2180909;-3978882;
6703;900128566;2019-12-31;2018;MILES;82444165;63788819;18655346;15383696;0;3271650;6054309;689924;3936884;582249;-1579481;-4636658;3057177;
6704;900174068;2019-12-31;2019;MILES;7205953;0;7205953;27404256;0;-20198303;0;26475;0;79390;-20145388;40562;-20185950;
6705;900174068;2019-12-31;2018;MILES;6852838;0;6852838;1574606;0;5278232;0;27427;0;137570;5388375;162002;5226373;
6706;900307868;2019-12-31;2019;MILES;34389100;32573944;1815156;3185938;446383;-1817165;50218;20780;244043;134745;-1509375;-426025;-1083350;
6707;900307868;2019-12-31;2018;MILES;7063680;5233319;1830361;394997;1383620;51744;12014;156013;478784;131372;493873;30237;463636;
6708;860037900;2019-12-31;2019;MILES;202692171;82927916;119764255;20414637;20771464;78578154;17928225;801766;468235;1035724;61394458;-451142;61845600;
6709;860037900;2019-12-31;2018;MILES;256721345;167131140;89590205;15173014;12001639;62415552;10072572;494446;1066216;708713;53679550;3252071;50427479;
6710;800032281;2019-12-31;2019;MILES;196387;0;196387;166915;0;29472;111527;0;58595;0;-2639548;12971;-2652519;
6711;800032281;2019-12-31;2018;MILES;198211;0;198211;144076;0;54135;150849;0;61200;2884;-2786114;13908;-2800022;
6712;900179369;2019-12-31;2019;MILES;307250036;261216561;46033475;27428737;2300535;16304203;5951819;530756;896409;2410015;24016468;5761242;18255226;
6713;900179369;2019-12-31;2018;MILES;239368164;202474456;36893708;24928623;2522090;9442995;4919286;826101;1142066;964459;20074869;2808747;17266122;
6714;900306166;2019-12-31;2019;MILES;71703;16900;54803;386439;0;-331636;0;0;748773;2517850;2934987;20444;2914543;
6715;900306166;2019-12-31;2018;MILES;291192;199440;91752;2313520;0;-2221768;0;0;650919;473576;-1097273;25565;-1122838;
6716;900799976;2019-12-31;2019;MILES;70882032;53027479;17854553;19601972;2844413;-4591832;297267;427034;0;6967061;1650928;751678;899250;
6717;900799976;2019-12-31;2018;MILES;47121898;33042612;14079286;12707288;1934750;-562752;855212;901256;0;4817160;3168612;882263;2286349;
6718;844000670;2019-12-31;2019;MILES;117464032;104841760;12622272;8378380;0;4243892;295461;2536258;141718;979171;2621011;1996397;624614;
6719;844000670;2019-12-31;2018;MILES;123939923;109111649;14828274;8520837;0;6307437;363428;1761641;120301;1256201;5558870;-865413;6424283;
6720;900298569;2019-12-31;2019;MILES;3321549;1557212;1764337;858539;113936;791862;200570;12556;2639;84490;665865;409068;256797;
6721;900298569;2019-12-31;2018;MILES;2994606;1265565;1729041;1059171;73692;596178;239450;80527;0;312742;588943;141440;447503;
6722;890935966;2019-12-31;2019;MILES;16270711;12309102;3961609;2586591;558919;816099;184299;183411;180007;924349;1552745;351938;1200807;
6723;890935966;2019-12-31;2018;MILES;4132562;1065682;3066880;2403245;3474231;-2810596;112153;336497;0;4544365;1285119;286040;999079;
6724;800222763;2019-12-31;2019;MILES;2113775;1046521;1067254;3472868;0;-2405614;2394962;5681467;0;9913023;-569020;74860;-643880;
6725;800222763;2019-12-31;2018;MILES;3825863;1068484;2757379;3649874;0;-892495;3773824;22613389;0;9340302;-17939406;0;-20834880;
6726;804014471;2019-12-31;2019;MILES;11415316;630657;10784659;2996936;150263;7637460;2060933;2709521;47016;201487;3115509;459599;2655910;
6727;804014471;2019-12-31;2018;MILES;11007295;1772814;9234481;1877177;196496;7160808;2430761;3689895;71875;612316;1724343;763805;960538;
6728;830070966;2019-12-31;2019;MILES;6926091;5985005;941086;1986824;0;-1045738;1359952;366250;0;0;-1550196;1008275;-2558471;
6729;830070966;2019-12-31;2018;MILES;3682977;802322;2880655;2163907;0;716748;1884089;121698;0;0;-764836;1464424;-2229260;
6730;800158941;2019-12-31;2019;MILES;4702451;3257919;1444532;704739;394680;345113;0;665138;0;281754;170454;124110;46344;
6731;800158941;2019-12-31;2018;MILES;4240010;3170825;1069185;590466;351039;127680;0;213246;0;311607;349656;59544;290112;
6732;900128677;2019-12-31;2019;MILES;0;4322;-4322;47310;0;-51632;0;607474;301;192371;-466434;46352;-512786;
6733;900128677;2019-12-31;2018;MILES;0;727;-727;44934;0;-45661;0;15258;51;49075;-11793;90418;-102211;
6734;900128678;2019-12-31;2019;MILES;0;12740;-12740;50653;0;-63393;0;46708;860;641432;532191;166454;365737;
6735;900128678;2019-12-31;2018;MILES;0;3785;-3785;57179;0;-60964;0;18456;0;218387;138967;57129;81838;
6736;800109273;2019-12-31;2019;MILES;107485571;107059802;425769;0;4233833;-3808064;1077386;78308;280406;5679243;995891;470283;525608;
6737;800109273;2019-12-31;2018;MILES;79690710;77645215;2045495;0;4505998;-2460503;354604;60457;1541930;5830292;4496658;2149608;2347050;
6738;860002274;2019-12-31;2019;MILES;154225413;93598497;60626916;17867864;31692204;11066848;0;0;0;0;5564737;1596316;3968421;
6739;860002274;2019-12-31;2018;MILES;147411668;96070904;51340764;13543295;29871321;7926148;0;0;0;0;3439188;1736026;1703162;
6740;890200474;2019-12-31;2019;MILES;467967383;345839833;122127550;24105618;63783665;34238267;0;30773546;0;6074396;9539117;3376137;6162980;
6741;890200474;2019-12-31;2018;MILES;371326049;279547705;91778344;18082123;49713510;23982711;0;27560464;0;4479527;901774;853594;48180;
6742;800094791;2019-12-31;2019;MILES;23040935;14720790;8320145;3871555;1939026;2509564;2276755;52713;29233;216279;502831;145115;357716;
6743;800094791;2019-12-31;2018;MILES;16137180;11133476;5003704;3306199;1298116;399389;689509;42492;802195;216847;1299320;223303;1076017;
6744;830091676;2019-12-31;2019;MILES;37782243;18352362;19429881;4771009;8315181;6343691;222493;4252851;71584;1163974;3436505;1183949;2252556;
6745;830091676;2019-12-31;2018;MILES;34932622;14742591;20190031;4342684;8385875;7461472;314239;5035806;37688;1401398;3757044;1449590;2307454;
6746;890302571;2019-12-31;2019;MILES;2367942;923245;1444697;1197972;0;246725;129044;132378;42956;268435;179191;-200114;379305;
6747;890302571;2019-12-31;2018;MILES;2326695;1012644;1314051;1292619;0;21432;124131;176268;42241;472487;124870;-1648867;1773737;
6748;860506688;2019-12-31;2019;MILES;16281919;13572619;2709300;1794341;0;914959;0;11022494;0;145642;-9961893;8143;-9970036;
6749;860506688;2019-12-31;2018;MILES;35455973;40509362;-5053389;6296433;0;-11349822;0;8057323;0;16542554;-2864591;-3470981;606390;
6750;800154771;2019-12-31;2019;MILES;57134709;47853928;9280781;3880460;0;5400321;569696;5223428;0;875783;482980;207199;275781;
6751;800154771;2019-12-31;2018;MILES;41393599;39069655;2323944;3458235;0;-1134291;235733;0;269190;1579636;600799;267209;333590;
6752;800012375;2019-12-31;2019;MILES;234606901;207818026;26788875;14728864;5683711;6376300;27327462;20230;19380626;0;4743447;1273196;3470251;
6753;800012375;2019-12-31;2018;MILES;209642028;191443417;18198611;9800528;5032698;3365385;28537562;1463563;22571883;0;-3875928;39822;-3915750;
6754;816006799;2019-12-31;2019;MILES;213710578;162870416;50840162;11577418;10025317;29237427;0;28603828;0;0;17073932;0;10870994;
6755;816006799;2019-12-31;2018;MILES;134144334;109279874;24864460;21735409;10561850;-7432799;0;15438594;0;0;18119947;0;22570616;
6756;890323576;2019-12-31;2019;MILES;22433239;14661228;7772011;3966636;703579;3101796;2602312;22240;0;1611884;2089128;1107451;981677;
6757;890323576;2019-12-31;2018;MILES;24759194;13618951;11140243;4289231;994334;5856678;1974800;47124;0;1792849;5627603;1516930;4110673;
6758;891400378;2019-12-31;2019;MILES;419147776;356799031;62348745;17981395;41633607;2733743;12038043;18708505;0;27115528;-66966;1572205;-1639171;
6759;891400378;2019-12-31;2018;MILES;397495380;316445175;81050205;17135454;61456902;2457849;12382759;14618090;0;21690283;-2234448;-179179;-2055269;
6760;900124375;2019-12-31;2019;MILES;0;0;0;327591;0;-327591;5052066;0;12266803;0;6607177;-536646;7143823;
6761;900124375;2019-12-31;2018;MILES;0;0;0;376744;0;-376744;2528260;0;7102470;0;4167391;30480;4136911;
6762;900509577;2019-12-31;2019;MILES;29778768;0;29778768;4329673;0;25449095;0;1517816;0;427215;24358494;123101;24235393;
6763;900509577;2019-12-31;2018;MILES;19661780;0;19661780;201383;0;19460397;0;621221;0;1174717;20013893;217679;19796214;
6764;860001474;2019-12-31;2019;MILES;5300;0;5300;1446307;0;-1441007;10644767;83991;5457;143630;28696501;10726008;17970493;
6765;860001474;2019-12-31;2018;MILES;1432;0;1432;1374656;0;-1373224;10068856;99128;3716;541;25192286;7876300;17315986;
6766;805005674;2019-12-31;2019;MILES;1752082;0;1752082;1491216;0;260866;193070;97665;10046;832981;813158;160729;652429;
6767;805005674;2019-12-31;2018;MILES;1775893;0;1775893;1435132;0;340761;294068;109144;82386;442683;462618;191003;271615;
6768;800165377;2019-12-31;2019;MILES;226647735;132766416;93881319;11401786;76002017;6477516;11976904;3636553;7292544;2884978;1041581;1605240;-563659;
6769;800165377;2019-12-31;2018;MILES;209558900;122046869;87512031;9974672;62624482;14912877;9260957;1496446;5847148;2622484;12625106;4641041;7984065;
6770;900479595;2019-12-31;2019;MILES;6620987;0;6620987;315208;0;6305779;0;1620;199652;236448;6793427;41988;6751439;
6771;900479595;2019-12-31;2018;MILES;840000;0;840000;666424;0;173576;0;113581;0;1850166;6397648;261549;6136099;
6772;860074671;2019-12-31;2019;MILES;12719465;18965785;-6246320;2868602;291477;-9406399;1662831;3824342;584365;9775861;-4533666;-47829;-4485837;
6773;860074671;2019-12-31;2018;MILES;34892424;19402748;15489676;6595061;470888;8423727;1227949;4174440;6609;4873865;7849523;4724861;3124662;
6774;805005383;2019-12-31;2019;MILES;93240914;84833868;8407046;1377254;6595588;434204;311499;945800;1090021;176905;678590;164072;514518;
6775;805005383;2019-12-31;2018;MILES;89794027;80246668;9547359;1449328;6219019;1879012;1089130;1233247;523889;465932;808496;540379;268117;
6776;890903475;2019-12-31;2019;MILES;33149354;19677503;13471851;2828974;1912862;8730015;1486448;204843;213872;341062;7593658;1887432;5706226;
6777;890903475;2019-12-31;2018;MILES;24453842;15888644;8565198;2151072;2941460;3472666;1463761;215155;18383;556932;2369065;156433;2212632;
6778;860354473;2019-12-31;2019;MILES;78148342;41387536;36760806;5021727;422304;31316775;374536;0;677736;187475;32567722;10988939;21578783;
6779;860354473;2019-12-31;2018;MILES;69666546;38322432;31344114;5652925;354201;25336988;30221;0;633857;15287;26190530;9928972;16261558;
6780;860070078;2019-12-31;2019;MILES;52063778;42576681;9487097;3040037;4747867;1699193;1627111;287762;594444;480300;859064;335705;523359;
6781;860070078;2019-12-31;2018;MILES;49689079;39759718;9929361;3051766;4719450;2158145;1365838;359895;639089;312402;1383903;595069;788834;
6782;800020274;2019-12-31;2019;MILES;25565882;22409720;3156162;2455231;429089;271842;358835;334731;693332;123634;395242;1123806;-728564;
6783;800020274;2019-12-31;2018;MILES;24674664;22302081;2372583;2543670;891784;-1062871;735639;180429;898454;496531;-583954;243597;-827551;
6784;860353473;2019-12-31;2019;MILES;64378920;52782002;11596918;4445401;0;7151517;0;666159;0;0;6485358;71099;6414259;
6785;860353473;2019-12-31;2018;MILES;29682376;22463967;7218409;3038703;0;4179706;0;503036;0;0;3676670;-323713;4000383;
6786;860002585;2019-12-31;2019;MILES;84928006;58895483;26032523;5340668;18731452;1960403;3342859;625794;46571;655245;-1274171;407411;-1681582;
6787;860002585;2019-12-31;2018;MILES;92348632;64858365;27490267;5496040;18760633;3233594;3559910;1350122;46280;6515231;4885073;935611;3949462;
6788;860052989;2019-12-31;2019;MILES;74275917;55639193;18636724;11583236;8394744;-1341256;7472418;657987;8603114;1139521;1248192;307801;940391;
6789;860052989;2019-12-31;2018;MILES;67788952;43047971;24740981;11719066;6832505;6189410;2715975;219866;113898;732311;10615915;2314360;8301555;
6790;890800467;2019-12-31;2019;MILES;81869694;64177711;17691983;17914222;0;-222239;2991401;0;5234546;2179858;4200764;1242864;2957900;
6791;890800467;2019-12-31;2018;MILES;69793930;54647114;15146816;25390752;0;-10243936;3534092;0;4375268;17418704;8015944;2479484;5536460;
6792;800180982;2019-12-31;2019;MILES;30377362;36871919;-6494557;4393637;0;-10888194;1654146;511912;882349;10164503;-2007400;-171420;-1835980;
6793;800180982;2019-12-31;2018;MILES;39305380;39754664;-449284;9316020;0;-9765304;1693226;433558;271912;2018128;-9602048;-2113741;-7488307;
6794;900662390;2019-12-31;2019;MILES;27977230;12594209;15383021;7644748;6194967;1543306;517154;415556;0;470815;1081411;571463;509948;
6795;900662390;2019-12-31;2018;MILES;28197995;17754893;10443102;3493343;6053761;895998;694183;516728;0;357645;42732;14572;28160;
6796;805018583;2019-12-31;2019;MILES;43061555;35014467;8047088;6066519;3417544;-1436975;601834;114572;704601;502200;-737664;0;-737664;
6797;805018583;2019-12-31;2018;MILES;53041688;36620064;16421624;6554505;3324658;6542461;383675;256352;938933;451410;4599818;0;4599818;
6798;900439474;2019-12-31;2019;MILES;3415532;879669;2535863;1860883;0;674980;14895337;102094;317300;101584;-13903567;-3669740;-10233827;
6799;900439474;2019-12-31;2018;MILES;20312551;809253;19503298;706360;0;18796938;24069564;118375;100524;39347;-5251130;-5196176;-54954;
6800;890320974;2019-12-31;2019;MILES;0;0;0;356988;0;-356988;8504;0;21;2;7819515;2041;7817474;
6801;890320974;2019-12-31;2018;MILES;0;0;0;261556;0;-261556;0;0;164;1;4600213;9824;4590389;
6802;802008192;2019-12-31;2019;MILES;106511449;81275089;25236360;4627469;14569037;6039854;3144076;0;332860;179305;3407943;1035261;2372682;
6803;802008192;2019-12-31;2018;MILES;95135464;70483440;24652024;4033283;13174871;7443870;3222713;0;19248;300583;4540988;1114399;3426589;
6804;860054073;2019-12-31;2019;MILES;85632704;80659697;4973007;2768122;0;2204885;7310889;73699;7194148;112641;2347633;403471;1944162;
6805;860054073;2019-12-31;2018;MILES;93141605;89419200;3722405;3032824;0;689581;6217353;147297;4620121;149990;-652219;53987;-706206;
6806;900246080;2019-12-31;2019;MILES;24057894;14433810;9624084;1105233;0;8518851;144613;924;110326;171138;8654778;2855440;5799338;
6807;900246080;2019-12-31;2018;MILES;8986401;6460595;2525806;796705;0;1729101;50879;351;154871;184793;2017535;453449;1564086;
6808;860080273;2019-12-31;2019;MILES;4985617;625566;4360051;3353563;0;1006488;121575;1182020;7360867;4;6948979;0;8013978;
6809;860080273;2019-12-31;2018;MILES;2435872;1349786;1086086;3487061;0;-2400975;46642;1912850;601103;72669;-12792371;0;-13829111;
6810;900241676;2019-12-31;2019;MILES;195617105;173652135;21964970;15975858;847345;5141767;8658164;0;1084193;1032281;-1399923;-93265;-1306658;
6811;900241676;2019-12-31;2018;MILES;255181968;225277197;29904771;15831216;1402741;12670814;5795779;0;417039;604749;7896823;2846729;5050094;
6812;830007073;2019-12-31;2019;MILES;17613198;13352038;4261160;2682415;0;1578745;341208;499155;145187;68497;1197455;532839;664616;
6813;830007073;2019-12-31;2018;MILES;10314464;9171615;1142849;2012019;0;-869170;866924;44511;276275;13304;-580699;-154426;-426273;
6814;860535490;2019-12-31;2019;MILES;15501248;10351809;5149439;1917937;0;3231502;967908;431655;808934;0;1447362;783559;663803;
6815;860535490;2019-12-31;2018;MILES;16831134;12806324;4024810;2160363;0;1864447;1267694;360587;1469439;0;2180398;956565;1223833;
6816;900265172;2019-12-31;2019;MILES;142381074;0;142381074;112805;0;142268269;657;10205;485098;6072;142748577;172913;142575664;
6817;900265172;2019-12-31;2018;MILES;131105393;0;131105393;92520;0;131012873;18458;12342;225423;2;131207498;82534;131124964;
6818;830027386;2019-12-31;2019;MILES;92563415;73058598;19504817;12219986;0;7284831;9399133;151655;3726417;1153352;4274510;1877760;2396750;
6819;830027386;2019-12-31;2018;MILES;99915779;79546045;20369734;10739411;0;9630323;9530735;55659;2992964;1028149;5168287;897820;4270467;
6820;900861975;2019-12-31;2019;MILES;0;0;0;190015;0;-190015;5062;0;0;0;-1239344;-54565;-1184779;
6821;900861975;2019-12-31;2018;MILES;0;0;0;133836;0;-133836;3385;0;0;0;352775;-28061;380836;
6822;830092675;2019-12-31;2019;MILES;22971962;13452328;9519634;2059957;2068913;5390764;617779;0;93356;20869;4886421;1837079;3049342;
6823;830092675;2019-12-31;2018;MILES;17679771;8640195;9039576;2316088;1734886;4988602;394369;0;10987;2929;4593332;1844779;2748553;
6824;800080575;2019-12-31;2019;MILES;1480992;2666193;-1185201;4038992;63703;-5287896;328900;8667307;1993516;44730834;32440247;-84075;32524322;
6825;800080575;2019-12-31;2018;MILES;3449611;3487674;-38063;9317771;1167318;-10523152;497659;48685520;681117;4398162;-54627052;8945112;-63572164;
6826;860513493;2019-12-31;2019;MILES;264806299;43228875;221577424;64339624;35658813;121578987;32745299;5650586;3921862;7889767;152320434;4274727;148045707;
6827;860513493;2019-12-31;2018;MILES;260682812;48141898;212540914;62034728;39967229;110538957;34096215;4138214;3268772;9810113;136564069;-1193754;137757823;
6828;900032774;2019-12-31;2019;MILES;73608558;52179006;21429552;11823067;5882151;3724334;910262;255762;94391;131195;2783896;354941;2428955;
6829;900032774;2019-12-31;2018;MILES;66121261;46779791;19341470;9447876;4319519;5574075;434690;357707;206004;372434;5360116;2329242;3030874;
6830;860072172;2019-12-31;2019;MILES;230675426;167717991;62957435;16615166;7659267;38683002;12525073;33163986;0;0;-7006057;599767;-7605824;
6831;860072172;2019-12-31;2018;MILES;209130892;153078217;56052675;12955066;6759322;36338287;11174876;35922548;0;0;-10759137;135136;-10894273;
6832;900242672;2019-12-31;2019;MILES;20365841;18778493;1587348;253533;187916;1145899;156087;47834;68855;1254398;2265231;263224;2002007;
6833;900242672;2019-12-31;2018;MILES;11552059;6951788;4600271;175673;135454;4289144;43501;340213;84038;5128032;9117500;702032;8415468;
6834;800143588;2019-12-31;2019;MILES;4622004;4183001;439003;424551;78541;-64089;156136;140638;4;1389934;1029075;-57499;1086574;
6835;800143588;2019-12-31;2018;MILES;3190338;2797787;392551;407546;64024;-79019;136157;74238;5;3805118;3515709;136066;3379643;
6836;900174073;2019-12-31;2019;MILES;8201683;0;8201683;40009960;0;-31808277;0;1558954;0;494852;-32872379;1549726;-34422105;
6837;900174073;2019-12-31;2018;MILES;12916972;0;12916972;138177;0;12778795;0;1668742;0;1365579;12475632;1504999;10970633;
6838;900174077;2019-12-31;2019;MILES;17466555;0;17466555;14015923;0;3450632;0;94272;0;21834;3378194;431527;2946667;
6839;900174077;2019-12-31;2018;MILES;13081981;0;13081981;1417076;0;11664905;0;573132;0;845168;11936941;591858;11345083;
6840;890112475;2019-12-31;2019;MILES;861084459;694408845;166675614;30824000;40571327;95280287;31222658;3103524;199583;1753067;72090106;22779903;49310203;
6841;890112475;2019-12-31;2018;MILES;662467298;524266525;138200773;26770083;32365693;79064997;30867542;3563258;162787;2849326;44083792;18603524;25480268;
6842;830006973;2019-12-31;2019;MILES;6196574;0;6196574;1206699;0;4989875;0;1472658;259911;53;3777181;-95965;3873146;
6843;830006973;2019-12-31;2018;MILES;5415249;0;5415249;706855;0;4708394;0;1037;263306;1225;5065681;294205;4771476;
6844;830065974;2019-12-31;2019;MILES;50815894;52508015;-1692121;18504258;0;-20196379;6153531;11247007;943691;7336580;-29212054;671731;-29883785;
6845;830065974;2019-12-31;2018;MILES;94615473;86571908;8043565;19591650;0;-11548085;408640;16534710;2100211;7720005;-18500323;1021548;-19521871;
6846;860036884;2019-12-31;2019;MILES;179070605;0;179070605;156057305;0;23013300;6301877;914567;4088038;3165238;23050132;9554572;13495560;
6847;860036884;2019-12-31;2018;MILES;169948105;0;169948105;139409280;0;30538825;4450867;1155438;4205577;3589745;32727842;13456352;19271490;
6848;830077975;2019-12-31;2019;MILES;35255345;20249102;15006243;4878206;6068959;4059078;0;722646;0;0;3150844;1820830;1330014;
6849;830077975;2019-12-31;2018;MILES;44139583;22490466;21649117;5278257;5851148;10519712;0;2179017;0;0;8340695;2737271;5603424;
6850;900049274;2019-12-31;2019;MILES;9819527;8630767;1188760;1040624;0;148136;51388;42799;34773;192019;280741;92243;188498;
6851;900049274;2019-12-31;2018;MILES;10361589;8588469;1773120;1169750;0;603370;66360;329525;95489;228994;531968;249672;282296;
6852;811022882;2019-12-31;2019;MILES;41138884;31493131;9645753;1406184;4885034;3354535;1093390;531019;109947;64698;1904771;735090;1169681;
6853;811022882;2019-12-31;2018;MILES;34782663;24499453;10283210;1324546;4489931;4468733;421803;462474;75384;150695;3810535;1475195;2335340;
6854;860028580;2019-12-31;2019;MILES;344886108;275726384;69159724;15467579;43570043;10122102;9675346;149425;1502881;2008214;4155261;323751;3831510;
6855;860028580;2019-12-31;2018;MILES;305342510;240790066;64552444;16029961;34159011;14363472;10209286;214544;1723084;1007756;6979276;2776807;4202469;
6856;830038178;2019-04-30;2019;MILES;0;0;0;79607;0;-79607;0;893;0;2721;-77779;7035;-84814;
6857;830038178;2019-04-30;2018;MILES;846103;0;846103;118661;0;727442;0;41240;0;1208;687410;15332;672078;
6858;830038178;2019-10-31;2019;MILES;3532;0;3532;121212;0;-117680;0;1545;0;5470;-113755;10553;-124308;
6859;830038178;2019-10-31;2018;MILES;0;0;0;79607;0;-79607;0;893;0;2721;-77779;7035;-84814;
6860;830038178;2019-12-31;2019;MILES;19089;0;19089;28687;0;-9598;0;308;0;1319;-8587;2290;-10877;
6861;830038178;2019-12-31;2018;MILES;3532;0;3532;121212;0;-117680;0;1545;0;5470;-113755;10553;-124308;
6862;900452881;2019-12-31;2019;MILES;1529508;0;1529508;1104115;0;425393;0;4259;0;681349;2370697;333579;2037118;
6863;900452881;2019-12-31;2018;MILES;1483027;0;1483027;1046718;0;436309;0;620;0;1318020;1753709;351542;1402167;
6864;890302180;2019-12-31;2019;MILES;7976385;6036737;1939648;855932;746443;337273;657051;0;225440;0;-205237;-38276;-166961;
6865;890302180;2019-12-31;2018;MILES;9131416;6902999;2228417;1039335;877826;311256;820625;0;482610;0;-42720;14772;-57492;
6866;800002482;2019-12-31;2019;MILES;61995322;40185720;21809602;3378541;11924188;6506873;2537686;207144;1791840;701645;6255528;1793083;4462445;
6867;800002482;2019-12-31;2018;MILES;43463215;27556765;15906450;2749671;10314736;2842043;2608779;191974;1310630;472447;1824367;278475;1545892;
6868;800110980;2019-12-31;2019;MILES;278207909;0;278207909;114019185;0;164188724;11824898;148503571;5807719;10200;10177702;5360127;4817575;
6869;800110980;2019-12-31;2018;MILES;237124899;0;237124899;101558808;0;135566091;10361541;129163794;6262760;0;2303516;3757213;-1453697;
6870;830043084;2019-12-31;2019;MILES;246565785;204593182;41972603;4955403;15512985;21504215;12253465;1297872;251102;2207413;10653903;3791406;6862497;
6871;830043084;2019-12-31;2018;MILES;392339826;291389405;100950421;4688992;20057442;76203987;15380918;1344476;233684;4842452;66434269;25324690;41109579;
6872;800226094;2019-12-31;2019;MILES;5684145;2826103;2858042;906082;1049270;902690;340679;334683;229968;111209;568505;150217;418288;
6873;800226094;2019-12-31;2018;MILES;5392168;2793870;2598298;1013090;1327661;257547;249635;73807;257701;213052;301339;0;301339;
6874;900265584;2019-12-31;2019;MILES;91236078;66558462;24677616;19887003;0;4790613;16787449;955903;1163760;19723372;18839035;3139661;15699374;
6875;900265584;2019-12-31;2018;MILES;80997247;56856155;24141092;17981458;0;6159634;13981195;2330380;765215;11770862;11852390;-904016;12756406;
6876;830027574;2019-12-31;2019;MILES;65771065;50790403;14980662;4015620;0;10965042;1875597;3241826;0;0;10458286;1396765;9061521;
6877;830027574;2019-12-31;2018;MILES;58128105;52569633;5558472;4904929;0;653543;1499257;3277690;0;0;-472370;856707;-1329077;
6878;900061482;2019-12-31;2019;MILES;694171;0;694171;1139763;0;-445592;6810;66328;20123;6689;-491918;10930;-502848;
6879;900061482;2019-12-31;2018;MILES;1172308;0;1172308;1262726;0;-90418;61480;79961;33933;36624;-335300;32502;-367802;
6880;811020576;2019-12-31;2019;MILES;41688161;32544475;9143686;5525134;1157116;2461436;176627;694475;162036;274931;4273604;347633;3925971;
6881;811020576;2019-12-31;2018;MILES;35961498;30230286;5731212;5106432;1441039;-816259;39312;1725376;57810;592280;-541769;361668;-903437;
6882;800149695;2019-12-31;2019;MILES;2359740859;1941267064;418473795;311864752;22193691;84415352;23198492;2209486;289248;595568;59892190;16942841;42949349;
6883;800149695;2019-12-31;2018;MILES;1696660123;1339238828;357421295;269779853;15575894;72065548;11066740;1465174;1448216;211082;61192932;22498392;38694540;
6884;860522583;2019-12-31;2019;MILES;23084825;0;23084825;2384213;0;20700612;0;22504948;0;56573;323698;-2245772;2569470;
6885;860522583;2019-12-31;2018;MILES;5046620;0;5046620;2527004;0;2519616;0;675586;0;200071;3878259;294638;3583621;
6886;860023186;2019-12-31;2019;MILES;3172349;0;3172349;2198205;35254;938890;81980;30404;242263;5334;1074103;341409;732694;
6887;860023186;2019-12-31;2018;MILES;2370571;0;2370571;2411752;173792;-214973;45308;0;357723;412890;510332;48211;462121;
6888;800189687;2019-12-31;2019;MILES;205516735;188377242;17139493;3531577;4880106;8727810;4607730;0;153361;312072;4585513;2225128;2360385;
6889;800189687;2019-12-31;2018;MILES;186290369;168180294;18110075;3489779;4831303;9788993;8824241;641556;196073;0;519269;129538;389731;
6890;900526489;2019-12-31;2019;MILES;13183340;10532204;2651136;1516885;382332;751919;38511;88803;30491;678299;1333395;36214;1297181;
6891;900526489;2019-12-31;2018;MILES;1895676;654062;1241614;1433465;396394;-588245;60315;27500;97901;112004;-466155;395159;-861314;
6892;891300382;2019-12-31;2019;MILES;939653271;723706541;215946730;34217786;167848317;13880627;18290503;8094607;4860884;51441449;49112226;9729380;39382846;
6893;891300382;2019-12-31;2018;MILES;872649001;649848267;222800734;45575551;158787917;18437266;17133109;7871213;4146963;48926539;50775448;6398648;44376800;
6894;890304099;2019-12-31;2019;MILES;303067945;107052705;196015240;89976463;14653105;91385672;14991731;72193316;781674;5611779;15620267;1428603;14191664;
6895;890304099;2019-12-31;2018;MILES;265474587;95233394;170241193;81293659;13319447;75628087;8337966;58857639;771003;5394753;21930838;2276048;19654790;
6896;901232088;2019-12-31;2019;MILES;2310292;2814048;-503756;45371;0;-549127;22590;6965;266899;2;-311781;1106;-312887;
6897;901232088;2019-12-31;2018;MILES;206291;212049;-5758;2137;0;-7895;145;101;8141;0;0;69671;-69671;
6898;800221789;2019-12-31;2019;MILES;577878438;421654450;156223988;19115280;56425296;80683412;21754461;4808708;5165748;7100053;71492167;26043212;45448955;
6899;800221789;2019-12-31;2018;MILES;520646509;366383887;154262622;24418257;49591770;80252595;23154758;11531887;5136635;3880902;60053418;18868112;41185306;
6900;900818280;2019-12-31;2019;MILES;0;0;0;46329;0;-46329;9131;14939;0;0;478815;19;478796;
6901;900818280;2019-12-31;2018;MILES;0;0;0;50218;0;-50218;32129;159738;91946;0;-11828670;2335;-11831005;
6902;830101778;2019-12-31;2019;MILES;139077420;47829963;91247457;8579755;79412977;3254725;5107807;0;1381919;6068000;5596837;792845;4803992;
6903;830101778;2019-12-31;2018;MILES;128484582;47739328;80745254;5240897;75659791;-155434;5851458;3550387;0;0;-9557279;-731067;-8826212;
6904;800209481;2019-12-31;2019;MILES;43742941;31760130;11982811;5738840;2242122;4001849;1079083;280130;0;744430;8642447;1620786;7021661;
6905;800209481;2019-12-31;2018;MILES;35412983;25160778;10252205;4903875;1784668;3563662;891606;172136;0;585015;8406694;1409621;6997073;
6906;811034480;2019-12-31;2019;MILES;23247679;16441095;6806584;1321728;2947128;2537728;0;1547897;0;321969;1311800;507458;804342;
6907;811034480;2019-12-31;2018;MILES;22262156;15765862;6496294;1375252;2756650;2364392;0;1952080;0;564492;976804;476398;500406;
6908;860007590;2019-12-31;2019;MILES;53864889;28840322;25024567;7327472;31038531;-13341436;2422573;0;1309415;0;-12322239;58375;-12380614;
6909;860007590;2019-12-31;2018;MILES;56051561;30139132;25912429;9877423;30813921;-14778915;994258;458979;601317;1244870;-14385965;257480;-14643445;
6910;900243678;2019-12-31;2019;MILES;569211;0;569211;734811;0;-165600;110385;0;1882792;0;1606807;88967;1517840;
6911;900243678;2019-12-31;2018;MILES;551334;0;551334;2308305;0;-1756971;5143506;0;0;8475212;1574735;747768;826967;
6912;860006282;2019-12-31;2019;MILES;215136829;195711963;19424866;5661100;499050;13264716;4442354;1561929;0;2464071;9724504;5533039;4191465;
6913;860006282;2019-12-31;2018;MILES;190314542;169948433;20366109;5563119;397435;14405555;7487673;2102616;0;3720730;8535996;4415408;4120588;
6914;900485960;2019-12-31;2019;MILES;6249915;1837411;4412504;447442;5318;3959744;191039;3257;138904;9;5123698;-20288;5143986;
6915;900485960;2019-12-31;2018;MILES;41978;0;41978;357967;0;-315989;161551;720;122076;50055;1399102;-250389;1649491;
6916;890301886;2019-12-31;2019;MILES;996420988;772051389;224369599;82608948;90764653;50995998;28679655;8968829;841827;7939268;69135549;20277139;48858410;
6917;890301886;2019-12-31;2018;MILES;897131224;678824691;218306533;89013719;85102517;44190297;24342921;12702226;1486062;17796920;41172228;12401742;28770486;
6918;860054983;2019-12-31;2019;MILES;5296513;78704;5217809;10186769;0;-4968960;0;15131567;0;9561784;8735844;-3230853;11966697;
6919;860054983;2019-12-31;2018;MILES;5480612;0;5480612;10174192;0;-4693580;0;9760205;0;12911174;10568806;-1649449;12218255;
6920;800240190;2019-12-31;2019;MILES;10480239;4713654;5766585;11750636;0;-5984051;105906;420760;0;0;-752981;-714504;-38477;
6921;800240190;2019-12-31;2018;MILES;14842017;7396097;7445920;16093411;0;-8647491;0;409176;9088;0;-4824971;-76008;-4748963;
6922;830507278;2019-12-31;2019;MILES;263157413;237926847;25230566;8184912;45102006;-28056352;15730613;7175115;23945;1709498;-49482561;-4059010;-45423551;
6923;830507278;2019-12-31;2018;MILES;262712468;230071439;32641029;9102963;51384363;-27846297;9286335;1961996;27703;1407259;-35760006;-11917302;-23842704;
6924;830010181;2019-12-31;2019;MILES;162138804;112145624;49993180;8547033;65530449;-24084302;3906624;1160140;4193690;31155877;10867588;2397721;8469867;
6925;830010181;2019-12-31;2018;MILES;116672930;75383515;41289415;15163643;37560302;-11434530;3943554;130182;1541650;15269576;782606;3235137;-2452531;
6926;900149186;2019-12-31;2019;MILES;0;0;0;904970;0;-904970;0;6182;0;574;-910578;0;-910578;
6927;900149186;2019-12-31;2018;MILES;0;0;0;1257715;0;-1257715;0;7697;0;13381;-1252031;0;-1252031;
6928;900486584;2019-12-31;2019;MILES;1018826;0;1018826;54456;0;964370;0;0;0;0;83815444;460;83814984;
6929;900486584;2019-12-31;2018;MILES;1251287;0;1251287;31814;0;1219473;0;0;0;0;53024816;12561;53012255;
6930;800049489;2019-12-31;2019;MILES;15637980;11704355;3933625;707003;2759147;467475;560196;324346;93738;645029;346421;236361;110060;
6931;800049489;2019-12-31;2018;MILES;16336873;11363442;4973431;597283;3554274;821874;947352;140328;36832;252477;-221007;3696;-224703;
6932;900536880;2019-12-31;2019;MILES;0;0;0;7679;0;-7679;0;2863;0;610608;600066;0;600066;
6933;900536880;2019-12-31;2018;MILES;334285;0;334285;1875;0;332410;0;41757;0;0;290653;0;290653;
6934;900110385;2019-12-31;2019;MILES;309281;0;309281;163668;5604;140009;754;4;199173;13024;212623;-32451;245074;
6935;900110385;2019-12-31;2018;MILES;1495455;0;1495455;154647;3478;1337330;6153;5660;315017;860602;2392870;176543;2216327;
6936;800206584;2019-12-31;2019;MILES;215877479;168334311;47543168;30382507;10167208;6993453;14301899;1582652;10980279;266682;5879060;4717044;1162016;
6937;800206584;2019-12-31;2018;MILES;208646679;171623027;37023652;21976705;9545934;5501013;11518520;427653;8118280;80957;7726938;292148;7434790;
6938;805029384;2019-12-31;2019;MILES;15641127;11138848;4502279;3060983;1131222;310074;916302;1147902;354081;786421;-613628;316560;-930188;
6939;805029384;2019-12-31;2018;MILES;31940645;26041675;5898970;2562842;1548311;1787817;985749;909417;404411;559928;856990;779982;77008;
6940;890305795;2019-12-31;2019;MILES;108051255;33022493;75028762;9717799;58474049;6836914;1809174;597250;645449;994194;18668332;2156116;16512216;
6941;890305795;2019-12-31;2018;MILES;99397815;30467078;68930737;10938585;54749594;3242558;1279879;662687;1490121;675845;6081481;35610;6045871;
6942;900228696;2019-12-31;2019;MILES;0;0;0;1221185;0;-1221185;6646090;156973;0;0;-6250177;0;-6250177;
6943;900228696;2019-12-31;2018;MILES;0;0;0;739870;0;-739870;6788441;0;0;12349;-4895230;0;-4895230;
6944;890908985;2019-12-31;2019;MILES;646589;223558;423031;1095136;0;-672105;0;847209;4055129;569706;3105521;59708;3045813;
6945;890908985;2019-12-31;2018;MILES;650043;237701;412342;1720137;0;-1307795;0;3025477;879115;1886935;-1567222;129035;-1696257;
6946;800039996;2019-12-31;2019;MILES;761976213;636027116;125949097;119487451;0;6461646;5557251;1766079;0;1562754;701070;-4380454;5081524;
6947;800039996;2019-12-31;2018;MILES;686319992;575977708;110342284;106022130;0;4320154;784472;2128274;0;1845814;3253222;3396302;-143080;
6948;830124992;2019-12-31;2019;MILES;0;0;0;18768;0;-18768;162;3352;3940;0;313175;8587;304588;
6949;830124992;2019-12-31;2018;MILES;28124;0;28124;21373;9521;-2770;87;0;5206;1448;1074586;194944;879642;
6950;860009186;2019-12-31;2019;MILES;0;0;0;21998;0;-21998;0;3631;2150435;172508;2297314;145308;2152006;
6951;860009186;2019-12-31;2018;MILES;0;0;0;76168;0;-76168;0;9339;497337;72443;484273;164862;319411;
6952;900164089;2019-12-31;2019;MILES;20582537;0;20582537;2583286;0;17999251;1191054;13127541;122204;4887623;8693801;3001790;5692011;
6953;900164089;2019-12-31;2018;MILES;16986987;0;16986987;2925275;0;14061712;1111687;10810327;68359;4868537;7079374;2496799;4582575;
6954;890205584;2019-12-31;2019;MILES;20794320;18584481;2209839;1206047;0;1003792;4490902;48676;2484428;852046;-199312;166680;-365992;
6955;890205584;2019-12-31;2018;MILES;78212042;73671565;4540477;1557908;402200;2580369;2276164;330786;2070351;242768;2024143;267180;1756963;
6956;900182199;2019-12-31;2019;MILES;42065187;0;42065187;334981;0;41730206;184;1745;7827111;119;49555507;155757;49399750;
6957;900182199;2019-12-31;2018;MILES;88490693;0;88490693;298562;0;88192131;772813;607;1205048;147;88623906;720738;87903168;
6958;900091388;2019-12-31;2019;MILES;189922;0;189922;196858;0;-6936;1780860;222;1294786;0;-1877425;0;-2318071;
6959;900091388;2019-12-31;2018;MILES;43864;0;43864;1199388;0;-1155524;1581448;1938;651234;23680;-79530;0;-79530;
6960;900182199;2019-06-30;2019;MILES;88490693;0;88490693;298562;0;88192131;772813;607;1205048;147;88623906;720738;87903168;
6961;900182199;2019-06-30;2018;MILES;60930366;0;60930366;311496;0;60618870;1605567;0;24776;0;59038079;0;59038079;
6962;890200685;2019-12-31;2019;MILES;11688090;0;11688090;1323762;0;10364328;136262;582864;591086;613268;11082406;-24737;11107143;
6963;890200685;2019-12-31;2018;MILES;9781528;0;9781528;1481937;0;8299591;46596;843803;248397;1596985;9356798;-85481;9442279;
6964;860024586;2019-12-31;2019;MILES;200099811;185715101;14384710;25607137;0;-11222427;29150408;2118567;8575914;78352515;45005934;-5854467;50860401;
6965;860024586;2019-12-31;2018;MILES;235724098;180667938;55056160;49168389;0;5887771;36151008;3439109;17370581;44038117;27706352;-629444;28335796;
6966;890942987;2019-12-31;2019;MILES;31269949;20493967;10775982;2821439;5501520;2453023;2287480;352899;687773;230416;730833;599564;131269;
6967;890942987;2019-12-31;2018;MILES;28194100;19672937;8521163;2829765;5220855;470543;2740624;135543;682227;1375217;-348180;112846;-461026;
6968;900577987;2019-12-31;2019;MILES;2017454;0;2017454;155386;0;1862068;12299;424005;837865;2;2263631;98357;2165274;
6969;900577987;2019-12-31;2018;MILES;1899669;0;1899669;154674;0;1744995;18498;2;787862;2;2514359;241269;2273090;
6970;900023386;2019-12-31;2019;MILES;16528541;10401670;6126871;1068709;7188168;-2130006;0;304339;448223;0;-3071810;149197;-3221007;
6971;900023386;2019-12-31;2018;MILES;17007349;11024673;5982676;1204226;7960872;-3182422;0;241697;824914;0;-973346;256368;-1229714;
6972;860005986;2019-12-31;2019;MILES;45853157;32015633;13837524;6288768;0;7548756;11685090;1212898;0;11299383;5950151;-2088166;8038317;
6973;860005986;2019-12-31;2018;MILES;56501857;38637880;17863977;6392912;0;11471065;11202253;6139366;0;10250048;4379494;4283526;95968;
6974;860010192;2019-12-31;2019;MILES;75512820;47027677;28485143;5361710;644468;22478965;1941175;128856;0;2331445;23373893;7224232;16149661;
6975;860010192;2019-12-31;2018;MILES;58665569;41787496;16878073;5344467;680443;10853163;2752544;220873;0;4057333;11926190;3568589;8357601;
6976;890101692;2019-12-31;2019;MILES;83414133;54110181;29303952;6845713;4003298;18454941;979574;498362;418477;1657081;24559264;5574745;18984519;
6977;890101692;2019-12-31;2018;MILES;83397461;62197936;21199525;6418991;3929866;10850668;2337945;836603;412370;4841723;13137751;3991551;9146200;
6978;900197394;2019-12-31;2019;MILES;1827803;521322;1306481;1315503;203721;-212743;113427;27886;685445;2425092;3850233;421411;3428822;
6979;900197394;2019-12-31;2018;MILES;12156102;4267139;7888963;3839878;292635;3756450;209722;673154;704336;315836;3893746;-1420365;5314111;
6980;811010485;2019-12-31;2019;MILES;233032756;189233619;43799137;11923340;778108;31097689;0;3743050;0;210409;27633451;7994023;19639428;
6981;811010485;2019-12-31;2018;MILES;179955725;145189334;34766391;10241844;445607;24078940;0;1644177;0;156296;23013071;10978255;12034816;
6982;811009788;2019-12-31;2019;MILES;2120629845;1874573783;246056062;15949084;147244227;82862751;38382381;0;1604682;914298;47549165;2434826;45114339;
6983;811009788;2019-12-31;2018;MILES;1849200932;1635762740;213438192;15157604;128438266;69842322;37306292;0;3609386;1817006;41271251;3175883;38095368;
6984;860026895;2019-12-31;2019;MILES;1528594309;1396979648;131614661;33112638;39156294;59345729;10984687;2989988;0;14702271;60073325;15376759;44696566;
6985;860026895;2019-12-31;2018;MILES;1310200191;1215129028;95071163;30763666;36824438;27483059;10818509;11568244;0;21577656;30679394;9883848;20795546;
6986;900824186;2019-12-31;2019;MILES;39397344;17957832;21439512;3930150;14910618;2598744;1386521;242536;354155;297212;2112738;1167400;945338;
6987;900824186;2019-12-31;2018;MILES;41151212;18335735;22815477;3284608;14957054;4573815;265229;145634;111059;199036;4600199;1399367;3200832;
6988;860001386;2019-12-31;2019;MILES;32275970;20386560;11889410;5080164;3831562;2977684;2417834;971036;1079932;1033037;1736914;624438;1112476;
6989;860001386;2019-12-31;2018;MILES;31167265;17901779;13265486;4570369;4681152;4013965;2530482;612706;1158515;1377267;3390756;1513495;1877261;
6990;830068589;2019-12-31;2019;MILES;0;0;0;6022;0;-6022;0;0;0;0;-616344;208;-616552;
6991;830068589;2019-12-31;2018;MILES;0;0;0;6323;0;-6323;0;0;0;0;-300553;492;-301045;
6992;860531287;2019-12-31;2019;MILES;314871616;253628718;61242898;14070134;32936610;14236154;7422042;272911;2749782;823263;9433210;4660864;4772346;
6993;860531287;2019-12-31;2018;MILES;262362694;209466345;52896349;8989402;31633927;12273020;8648243;313383;1641588;880035;3314245;1893679;1420566;
6994;811003486;2019-12-31;2019;MILES;78907441;7280973;71626468;60556721;11316028;-246281;4716218;1326689;71895;8270282;6124839;1220690;4904149;
6995;811003486;2019-12-31;2018;MILES;73118843;6763774;66355069;54968926;2538196;8847947;4713717;2802282;2173778;7655297;11161023;4262424;6898599;
6996;900860284;2019-12-31;2019;MILES;265567185;149469589;116097596;10069924;130837232;-24809560;27410268;3558876;269108;906942;-56319312;-283296;-56036016;
6997;900860284;2019-12-31;2018;MILES;212637918;130172387;82465531;8145992;97139451;-22819912;21989302;5962233;108694;1606203;-49277473;-73814;-49203659;
6998;830075074;2019-12-31;2019;MILES;35849842;29315651;6534191;3101867;3388847;43477;779708;346626;86363;1590990;594496;151511;0;
6999;830075074;2019-12-31;2018;MILES;38087232;30352383;7734849;3079469;4179267;476113;656002;381777;122669;2769400;2330403;747049;5487214;
7000;800182895;2019-12-31;2019;MILES;6734310;3379797;3354513;1022470;0;2332043;1512211;11569;1123;18413;9059084;517758;8541326;
7001;800182895;2019-12-31;2018;MILES;6521800;2857466;3664334;1795758;0;1868576;1570146;64572;1418;114530;574961;708750;-133789;
7002;805025887;2019-12-31;2019;MILES;1359337;1124877;234460;806079;102490;-674109;2398649;100193;15;122104;-3164039;84656;-3248695;
7003;805025887;2019-12-31;2018;MILES;3321974;1354512;1967462;855263;214736;897463;252907;27816;159;18485;594958;257570;337388;
7004;900184187;2019-12-31;2019;MILES;60431456;48342898;12088558;1207208;0;10881350;0;8718867;0;216232;2378715;648370;1730345;
7005;900184187;2019-12-31;2018;MILES;54788521;45125886;9662635;1156281;0;8506354;0;6899433;0;4617434;6224355;581687;5642668;
7006;802004090;2019-12-31;2019;MILES;87392900;69866841;17526059;4012494;6384252;7129313;2102430;0;8086;469091;5504060;1875715;3628345;
7007;802004090;2019-12-31;2018;MILES;82722938;67362427;15360511;3584109;6717168;5059234;1246312;0;14267;423287;4250476;1619677;2630799;
7008;900194463;2019-12-31;2019;MILES;527051;181941;345110;452768;0;-107658;17250;4275;4422;0;1189315;21331;1167984;
7009;900194463;2019-12-31;2018;MILES;538869;81157;457712;462077;0;-4365;14134;2361;4920;74209;1639240;1818;1637422;
7010;890206592;2019-12-31;2019;MILES;63724975;46601913;17123062;10655832;0;6467230;0;5489746;0;101339;1078823;2205677;-1126854;
7011;890206592;2019-12-31;2018;MILES;63688238;46031084;17657154;11032549;0;6624605;0;381196;0;1295575;7538984;2772419;4766565;
7012;890916988;2019-12-31;2019;MILES;22894310;15366745;7527565;6038287;2373077;-883799;257722;32692;90206;0;-697899;-657909;-39990;
7013;890916988;2019-12-31;2018;MILES;24191374;15418215;8773159;5300148;2431946;1041065;443736;143351;64043;0;1066842;537973;528869;
7014;860527800;2019-12-31;2019;MILES;61236067;53365756;7870311;4163338;0;3706973;101599;2004415;543624;0;2144583;515702;1628881;
7015;860527800;2019-12-31;2018;MILES;66808813;59309521;7499292;3223868;0;4275424;664433;1944632;988398;0;2654757;110544;2544213;
7016;860002291;2019-12-31;2019;MILES;94780488;81540238;13240250;7604755;3121189;2514306;3263347;0;7529;545818;-6119197;1054208;-7173405;
7017;860002291;2019-12-31;2018;MILES;95547401;81428299;14119102;8972780;3327623;1818699;5107990;0;6491;425285;-5997797;-2237964;-3759833;
7018;832006599;2019-12-31;2019;MILES;477182777;377701028;99481749;75797114;0;23684635;22665994;7296875;58974581;60304973;179139751;14700898;164438853;
7019;832006599;2019-12-31;2018;MILES;463903271;339861414;124041857;50441347;0;73600510;27294512;7824218;52086293;24467747;206080298;58294854;147785444;
7020;900577591;2019-12-31;2019;MILES;0;0;0;30936;0;-30936;1016;3643;0;17;-1100092;129;-1100221;
7021;900577591;2019-12-31;2018;MILES;0;0;0;55855;0;-55855;799;610;4;0;4545587;521;4545066;
7022;890906295;2019-12-31;2019;MILES;2408292;0;2408292;2215316;0;192976;10569;79556;431278;172233;268963;422094;-153131;
7023;890906295;2019-12-31;2018;MILES;3072524;0;3072524;2387390;0;685134;9600;3473653;643545;38535;-2379745;704767;-2936968;
7024;900342297;2019-12-31;2019;MILES;461846159;273784735;188061424;24294279;116869742;46897403;5312789;2302920;2994953;8684768;47035234;15327020;31708214;
7025;900342297;2019-12-31;2018;MILES;459104361;268191732;190912629;40667727;112741331;37503571;6262122;1266481;910739;3168702;32893250;13876432;19016818;
7026;800185295;2019-12-31;2019;MILES;1115445749;988686159;126759590;54491221;284004;71984365;33151489;4521228;480152;16073622;50865422;5300000;45565422;
7027;800185295;2019-12-31;2018;MILES;912170776;801293493;110877283;47869261;311486;62696536;30175212;1514292;411828;14288588;45707448;5032813;40674635;
7028;800245795;2019-12-31;2019;MILES;261404435;211112871;50291564;17958362;59732982;-27399780;903828;1998812;0;3776419;-26790065;-122899;-26667166;
7029;800245795;2019-12-31;2018;MILES;263390607;196850318;66540289;23825881;59503243;-16788835;0;1617256;14984;9133388;-9364459;473894;-9838353;
7030;900685695;2019-12-31;2019;MILES;940391;0;940391;9190;0;931201;0;0;0;0;931201;-46;931247;
7031;900685695;2019-12-31;2018;MILES;8301556;0;8301556;16020;0;8285536;0;928;0;0;8284608;191;8284417;
7032;860055794;2019-12-31;2019;MILES;1657352;2040352;-383000;316399;15295;-714694;12217;21208;9161;66051;-642965;-10453;-632512;
7033;860055794;2019-12-31;2018;MILES;1803079;2258900;-455821;414379;32280;-902480;5331;1453;1103;11276;-867572;-51011;-816561;
7034;800208590;2019-12-31;2019;MILES;57297274;52056229;5241045;2120892;516669;2603484;1359513;202086;214200;5471346;6727431;563149;6164282;
7035;800208590;2019-12-31;2018;MILES;53513279;45679330;7833949;2325586;694219;4814144;1391079;184162;859597;8044015;12142515;637654;11504861;
7036;900560199;2019-12-31;2019;MILES;0;0;0;94963;0;-94963;6122358;0;5896151;0;19876741;857915;19018826;
7037;900560199;2019-12-31;2018;MILES;0;0;0;53375;0;-53375;4141844;0;1078401;0;3034300;171141;2863159;
7038;890319193;2019-12-31;2019;MILES;82832649;12792365;70040284;12923960;34262867;22853457;288669;734884;197055;599817;24661124;7344486;17316638;
7039;890319193;2019-12-31;2018;MILES;73829604;9437441;64392163;11318858;33014588;20058717;295405;963504;285876;1670874;20756558;7713195;13043363;
7040;900459993;2019-12-31;2019;MILES;73386332;82940;73303392;779147;0;72524245;0;0;0;0;72524245;144629;72379616;
7041;900459993;2019-12-31;2018;MILES;0;0;0;484716;0;-484716;0;8834860;0;309838558;300518982;24167;300494815;
7042;806000591;2019-12-31;2019;MILES;19652479;0;19652479;10480180;1736108;7436191;740580;934724;1085772;1574595;8421254;4071655;4349599;
7043;806000591;2019-12-31;2018;MILES;14619658;0;14619658;9849179;560921;4209558;351859;537781;4317137;1366287;9003342;2838133;6165209;
7044;890304297;2019-12-31;2019;MILES;82573745;16439774;66133971;16938598;31726076;17469297;2250135;7811801;41493;543374;9411475;3195132;6196246;
7045;890304297;2019-12-31;2018;MILES;87269139;17123460;70145679;16436294;44591948;9117437;1779423;9416915;54187;12049675;10406938;3109899;7274652;
7046;830007691;2019-12-31;2019;MILES;67911582;58975669;8935913;9518815;0;-582902;679912;1141947;575856;1689608;-139297;894608;-1033905;
7047;830007691;2019-12-31;2018;MILES;76364128;60902531;15461597;9043193;0;6418404;1100451;391775;630089;1612750;7169017;2512385;4656632;
7048;830004993;2019-12-31;2019;MILES;897657;758194;139463;8316;117683;13464;19761;2762;5798;10824;28485;987;27498;
7049;830004993;2019-12-31;2018;MILES;787548;665410;122138;8880;107393;5865;19303;2655;3174;13404;23681;1012;22669;
7050;830036191;2019-12-31;2019;MILES;4728944;1510194;3218750;2089528;0;1129222;0;1586607;0;954549;497164;680752;-183588;
7051;830036191;2019-12-31;2018;MILES;4572401;2425550;2146851;1789155;0;357696;0;3651561;0;803239;-2490626;56168;-2546794;
7052;900738674;2019-12-31;2019;MILES;261951570;237747140;24204430;12304555;0;11899875;5099467;0;937681;0;11296395;431564;10864831;
7053;900738674;2019-12-31;2018;MILES;262427874;235452156;26975718;10073128;0;16902590;4010691;0;870826;0;6030752;5626778;403974;
7054;900166896;2019-12-31;2019;MILES;641704510;609790742;31913768;8517893;5412048;17983827;4232666;21887416;113576;19980713;13328953;6106211;7222742;
7055;900166896;2019-12-31;2018;MILES;500524965;473010810;27514155;8482933;5335185;13696037;2794625;15470838;210377;11181126;8977210;-407204;9384414;
7056;860000596;2019-12-31;2019;MILES;52786102;39277529;13508573;6136690;4951033;2420850;3800450;145015;2341238;125020;1602226;830955;771271;
7057;860000596;2019-12-31;2018;MILES;55055422;42125784;12929638;5915168;5041083;1973387;4031388;159725;2286035;66771;252270;79639;172631;
7058;860025998;2019-12-31;2019;MILES;20640106;13487222;7152884;2684425;2466501;2001958;731462;110666;723175;190202;2965234;818162;2147072;
7059;860025998;2019-12-31;2018;MILES;19667828;13047736;6620092;2337745;2335284;1947063;917395;272671;601839;323707;1682543;746881;935662;
7060;860002590;2019-12-31;2019;MILES;524028013;432467944;91560069;19382771;55606165;16571133;13352141;0;0;2689488;8367505;4420378;3947127;
7061;860002590;2019-12-31;2018;MILES;491419013;398813455;92605558;19670869;53414763;19519926;11591122;0;0;715401;7881046;3296490;4584556;
7062;900657500;2019-12-31;2019;MILES;0;0;0;263193;0;-263193;65948;0;0;13112;2380547;54953;2325594;
7063;900657500;2019-12-31;2018;MILES;0;0;0;11946;15752;-27698;129;0;0;6273;363456;968;362488;
7064;830004799;2019-12-31;2019;MILES;24185888;22431500;1754388;1584157;166650;3581;814712;306292;452793;293101;-371529;-94368;-277161;
7065;830004799;2019-12-31;2018;MILES;26887048;23468668;3418380;1615937;208933;1593510;1070489;258828;404374;378389;1046956;481088;565868;
7066;830133698;2019-12-31;2019;MILES;6003205;5765881;237324;11918;0;225406;20431;1439;11037;223633;438206;148454;289752;
7067;830133698;2019-12-31;2018;MILES;1894813;1706363;188450;792;304666;-117008;13500;39053;84130;1476;-83955;38756;-122711;
7068;819004200;2019-12-31;2019;MILES;20064924;17896913;2168011;2299983;0;-131972;2855723;0;0;808385;-419381;-686850;267469;
7069;819004200;2019-12-31;2018;MILES;20147226;17330736;2816490;2517954;0;298536;408465;63351;18523;388464;1095895;302411;793484;
7070;900040299;2019-12-31;2019;MILES;228627235;182164556;46462679;2259703;27947293;16255683;1619991;420563;45;935409;15128126;5204039;9924087;
7071;900040299;2019-12-31;2018;MILES;185064190;143965461;41098729;1856862;27317083;11924784;1871504;85319;20;527749;10754749;4084842;6669907;
7072;811019499;2019-12-31;2019;MILES;30259964;13365846;16894118;8502110;4396190;3995818;362381;1997311;1088515;1738429;4463070;323851;4139219;
7073;811019499;2019-12-31;2018;MILES;27793271;11249954;16543317;8717753;4166003;3659561;377613;3110159;57743;4601837;4831369;917828;3913541;
7074;860075498;2019-12-31;2019;MILES;24599166;15432693;9166473;1935261;6379201;852011;861495;0;0;277980;-387173;125033;-512206;
7075;860075498;2019-12-31;2018;MILES;22538922;14379480;8159442;1868132;5422935;868375;532612;0;0;167443;193260;188569;4691;
7076;901006398;2019-12-31;2019;MILES;0;0;0;1356850;0;-1356850;71799;1964;927;0;2828841;2348;2826493;
7077;901006398;2019-12-31;2018;MILES;0;0;0;1892431;0;-1892431;107060;685;928;0;-5433277;20879;-5454156;
7078;860045854;2019-12-31;2019;MILES;395308103;273674163;121633940;116971949;3192304;1469687;17558391;911832;619889;1364619;-16314656;8978081;-25292737;
7079;860045854;2019-12-31;2018;MILES;381649478;259314201;122335277;115204539;4109678;3021060;16352904;359606;678248;1326832;-12188549;-6387110;-5801439;
7080;804014996;2019-12-31;2019;MILES;4870420;3982284;888136;1355146;298727;-765737;853434;583384;1167;1354209;-847179;50079;-897258;
7081;804014996;2019-12-31;2018;MILES;10316734;7613479;2703255;2067642;570819;64794;911217;346653;59038;1496347;362309;116878;245431;
7082;900451597;2019-12-31;2019;MILES;0;0;0;180960;0;-180960;8959;342;0;0;7820446;497;7819949;
7083;900451597;2019-12-31;2018;MILES;0;0;0;2688;0;-2688;0;0;0;0;-13638729;4797;-13643526;
7084;901168500;2019-12-31;2019;MILES;107041441;0;107041441;153735;0;106887706;163395;2022654;16594;22;104468784;0;104468784;
7085;901168500;2019-12-31;2018;MILES;71424769;0;71424769;374486;0;71050283;11810;332;55;0;71038196;0;71038196;
7086;830113598;2019-12-31;2019;MILES;1449429507;0;1449429507;47741005;0;1401688502;44306079;2704105;0;1623345;1356301663;19605002;1336696661;
7087;830113598;2019-12-31;2018;MILES;1600491714;228375050;1372116664;64946981;0;1307169683;35576069;97766818;0;2433398;1176260194;32758030;1143502164;
7088;890103400;2019-12-31;2019;MILES;353541193;285730958;67810235;6577377;34892399;26340459;10135605;14235086;0;4355499;7675497;2655356;5020141;
7089;890103400;2019-12-31;2018;MILES;321378726;258341596;63037130;5910341;31180254;25946535;11398245;11530933;0;2109663;5220336;1986009;3234327;
7090;830113599;2019-12-31;2019;MILES;19197134;0;19197134;3118550;0;16078584;1967141;22719;348823;195483;14633030;4634231;9998799;
7091;830113599;2019-12-31;2018;MILES;15246456;0;15246456;34664160;0;-19417704;1404531;400110;328329;30233;-20863783;2599655;-23463438;
7092;830113600;2019-12-31;2019;MILES;24460074;0;24460074;5542616;0;18917458;0;5942536;0;24107;12999029;707080;12291949;
7093;830113600;2019-12-31;2018;MILES;21815196;0;21815196;6106557;0;15708639;0;2938070;0;2;12770571;898004;11872567;
7094;860001697;2019-12-31;2019;MILES;835624971;505493177;330131794;64847295;193366196;71918303;5071478;2804265;641855;1325937;37807992;20233022;17574970;
7095;860001697;2019-12-31;2018;MILES;700084649;442555863;257528786;54986422;149724310;52818054;2302058;4680323;183556;841167;24926043;14838490;10087553;
7096;830041598;2019-12-31;2019;MILES;126067660;90182206;35885454;3778156;21667227;10440071;2028676;3936027;5020940;661939;17002892;4734027;12268865;
7097;830041598;2019-12-31;2018;MILES;105407426;66650292;38757134;756977;29938246;8061911;1283268;2899304;7818244;368403;27423248;4231387;23191861;
7098;802003400;2019-12-31;2019;MILES;21351780;11244845;10106935;57605947;0;-47499012;11092788;2470349;5402268;1314519;-47945749;-9800706;-38145043;
7099;802003400;2019-12-31;2018;MILES;35884940;22203369;13681571;63144059;0;-49462488;7755447;4507896;4214343;260000;-20117781;992856;-21110637;
7100;860002097;2019-12-31;2019;MILES;0;0;0;760002;0;-760002;651015;0;1317707;0;111729288;22116;111707172;
7101;860002097;2019-12-31;2018;MILES;14821;0;14821;605342;0;-590521;713100;0;0;1726;142436592;142298;142294294;
7102;900188396;2019-12-31;2019;MILES;50041518;41697863;8343655;2052007;7115289;-823641;3780760;0;2371291;0;-1043643;1056904;-2100547;
7103;900188396;2019-12-31;2018;MILES;36642891;30855377;5787514;2035801;6147539;-2395826;3089582;0;7103903;0;2032188;1587669;444519;
7104;900172584;2019-12-31;2019;MILES;20777186;18923733;1853453;470654;0;1382799;907838;114353;0;231232;591840;-48816;640656;
7105;900172584;2019-12-31;2018;MILES;18833900;17385333;1448567;419119;0;1029448;788941;126311;0;436081;550277;390308;159969;
7106;800090963;2019-12-31;2019;MILES;17978767;9049771;8928996;5334403;2653247;941346;0;2029319;0;581935;-506038;126732;-632770;
7107;800090963;2019-12-31;2018;MILES;14175171;9470976;4704195;8711795;215735;-4223335;0;798573;0;397232;-4624676;-215037;-4409639;
7108;830109997;2019-12-31;2019;MILES;37370939;23248326;14122613;4004929;6672484;3445200;4220433;0;3958726;0;3183493;487274;2696219;
7109;830109997;2019-12-31;2018;MILES;33667665;21140166;12527499;4229982;6146215;2151302;13319981;0;12039285;0;870606;378934;491672;
7110;900042771;2019-12-31;2019;MILES;45022381;42180596;2841785;6914930;0;-4073145;870063;0;16181;0;-4927027;255579;-5182606;
7111;900042771;2019-12-31;2018;MILES;30467480;22587037;7880443;7141115;0;739328;558036;0;9874;0;191166;514004;-322838;
7112;830042976;2019-12-31;2019;MILES;17993182;13225714;4767468;4900788;0;-133320;1034325;173550;0;524755;-816440;58883;-875323;
7113;830042976;2019-12-31;2018;MILES;16914614;13436072;3478542;10834898;0;-7356356;1000867;1138444;0;503865;-8991802;-418836;-8572966;
7114;860404924;2019-12-31;2019;MILES;40450731;33154664;7296067;2338226;5187099;-229258;1575769;308709;32584;2568239;487087;17943;463696;
7115;860404924;2019-12-31;2018;MILES;38962900;31477343;7485557;2584841;5582861;-682145;1132641;550773;33123;1352120;-980316;59697;-1028759;
7116;811014359;2019-12-31;2019;MILES;9032751;6381852;2650899;2172862;0;478037;2068606;0;0;20180;-1072172;42590;-1612979;
7117;811014359;2019-12-31;2018;MILES;15717549;15998502;-280953;2256335;0;-2537288;1450640;0;0;1530303;-3464610;241031;-2698656;
7118;811023986;2019-12-31;2019;MILES;17848;8846;9002;1801;10012;-2811;1566;14276;96;556;-18001;-231;-17770;
7119;811023986;2019-12-31;2018;MILES;22598;11139;11459;1965;9228;266;1981;398;381;157;-1575;-199;-1376;
7120;800021413;2019-12-31;2019;MILES;1255694;0;1255694;52697;0;1202997;1662;0;0;0;1201335;420425;780910;
7121;800021413;2019-12-31;2018;MILES;2785262;0;2785262;57087;0;2728175;125939;118103;0;0;2484133;596660;1887473;
7122;890900118;2019-12-31;2019;MILES;724825313;528680275;196145038;26655578;49987705;119501755;25326906;9291661;10280202;5204710;131016422;32084217;98932205;
7123;890900118;2019-12-31;2018;MILES;663841293;438684532;225156761;29661875;58057895;137436991;19621455;12367397;12356287;3115590;153613156;32145788;121467368;
7124;860041312;2019-12-31;2019;MILES;2611931991;3034372672;-422440681;0;0;-422440681;86467777;1746389760;0;0;-2117750881;208599257;-2326350138;
7125;860041312;2019-12-31;2018;MILES;3296460528;3313913850;-17453322;0;0;-17453322;46313162;168906086;0;0;-95103399;-13500389;-81603010;
7126;890932389;2019-12-31;2019;MILES;898888574;825908408;72980166;27246632;57728338;-11994804;24559606;10661990;1476621;3989345;-55773186;-4127859;-51645327;
7127;890932389;2019-12-31;2018;MILES;956858000;855042144;101815856;29235924;63396228;9183704;27196414;8765539;1944923;2255418;-28949210;-6387507;-22561703;
7128;890920304;2019-12-31;2019;MILES;1081983142;647906134;434077008;72565687;314075968;47435353;14874038;8733171;4468829;12894706;41191679;18794939;22396740;
7129;890920304;2019-12-31;2018;MILES;996021811;592350266;403671545;70788562;266571464;66311519;12188289;10440032;6615295;11498188;61796681;27738199;34058482;
7130;900331619;2019-12-31;2019;MILES;87523;0;87523;108520;0;-20997;0;0;0;1510373;1489376;0;1489376;
7131;900331619;2019-12-31;2018;MILES;98955;0;98955;90100;0;8855;0;0;0;1730294;1739149;0;1739149;
7132;805025964;2019-12-31;2019;MILES;292050169;0;292050169;68069909;0;223980260;170710252;73990056;49744518;49054575;8263990;3212285;5051705;
7133;805025964;2019-12-31;2018;MILES;340948841;0;340948841;17623363;0;323325478;189900611;72606883;2524267;906956;11932185;4580977;7351208;
7134;901037493;2019-12-31;2019;MILES;464941;0;464941;5562;0;459379;0;75;0;0;1090376;150748;939628;
7135;901037493;2019-12-31;2018;MILES;914639;0;914639;4938;0;909701;0;0;0;0;1270076;346564;923512;
7136;890937250;2019-12-31;2019;MILES;225141555;184358276;40783279;22862497;0;17920782;13241434;4832015;7557367;3466783;10871483;4886292;5985191;
7137;890937250;2019-12-31;2018;MILES;227562279;192698194;34864085;22806994;0;12057091;7021033;4536726;2061688;8230422;10791442;6996035;3795407;
7138;805011316;2019-12-31;2019;MILES;30549049;22151778;8397271;2070938;2752181;3574152;599631;610761;986732;82798;3433290;1228271;2205019;
7139;805011316;2019-12-31;2018;MILES;28158731;18922987;9235744;2302784;2291154;4641806;589229;1656515;151738;1841519;4389319;358934;4030385;
7140;800125872;2019-12-31;2019;MILES;109438957;26988427;82450530;31670270;0;50780260;7987042;1346195;8846499;645365;50938887;12723989;38214898;
7141;800125872;2019-12-31;2018;MILES;180044622;3056968;176987654;31397033;0;145590621;10532331;975357;3116531;487611;137687075;7433144;130253931;
7142;900135202;2019-12-31;2019;MILES;23136261;19465952;3670309;1957230;0;1713079;2942411;1565726;0;0;-2893428;-107154;-2786274;
7143;900135202;2019-12-31;2018;MILES;4060509;4330229;-269720;1961433;0;-2231153;2593358;0;1675696;0;-3148815;89302;-3238117;
7144;800106884;2019-12-31;2019;MILES;91893662;48202843;43690819;8167683;34198187;1324949;2054016;1589830;9343;1031242;-1278312;-5540;-1272772;
7145;800106884;2019-12-31;2018;MILES;84123834;47381723;36742111;5884330;29308109;1549672;1860577;7005384;154403;423705;-6738181;347703;-7085884;
7146;800021390;2019-12-31;2019;MILES;41178545;22469067;18709478;3663110;9781338;5265030;85233;2076945;1785067;2739956;7764624;2309068;5455556;
7147;800021390;2019-12-31;2018;MILES;30799105;18501229;12297876;2106689;7689549;2501638;74826;2148510;1424956;1790197;11594988;1335071;10259917;
7148;800042972;2019-12-31;2019;MILES;24527956;15786098;8741858;7741804;0;1000054;868526;1093285;1142308;2054931;2235482;694221;1541261;
7149;800042972;2019-12-31;2018;MILES;26277607;15404404;10873203;7532368;0;3340835;1777763;1037516;259794;1965354;2750704;1327507;1423197;
7150;901348706;2019-12-31;2019;MILES;0;0;0;2463503;0;-2463503;0;0;0;0;-2463503;0;-2463503;
7151;901348706;2019-12-31;2018;MILES;0;0;0;0;0;0;0;0;0;0;0;0;0;ERR valores en cero
7152;800030932;2019-12-31;2019;MILES;27119755;4590728;22529027;3796049;19955184;-1222206;0;6639873;0;162995;-7699084;-241004;-7458080;
7153;800030932;2019-12-31;2018;MILES;32263486;6072684;26190802;4823742;23771283;-2404223;0;7074897;0;717772;-8761348;0;-8761348;
7154;900169754;2019-12-31;2019;MILES;2341255;1495064;846191;913991;0;-67800;0;0;0;708134;640334;166905;473429;
7155;900169754;2019-12-31;2018;MILES;3042899;2084186;958713;1089565;0;-130852;0;0;0;193456;62604;150412;-87808;
7156;900442519;2019-12-31;2019;MILES;0;0;0;0;0;0;0;0;0;0;0;0;0;ERR valores en cero
7157;900442519;2019-12-31;2018;MILES;0;0;0;0;0;0;0;0;0;0;0;0;0;ERR valores en cero
7158;900208029;2019-12-31;2019;MILES;112660659;97099554;15561105;8900191;0;6660914;5735996;867742;1321619;0;1378795;1194863;183932;
7159;900208029;2019-12-31;2018;MILES;138551533;130836280;7715253;8101376;0;-386123;6464012;653186;1420489;0;-6082832;-640578;-5442254;
7160;860026759;2019-12-31;2019;MILES;336526354;237193352;99333002;21978869;16616082;60738051;24370312;1398386;3102247;8536161;54790027;16723103;38066924;
7161;860026759;2019-12-31;2018;MILES;309451078;222229820;87221258;20427079;16513124;50281055;97898140;699748;80794788;6415852;47910529;14111094;33799435;
7162;860001963;2019-12-31;2019;MILES;180011078;132321120;47689958;19665822;17381875;10642261;8490412;0;1073172;0;4359435;243710;4115725;
7163;860001963;2019-12-31;2018;MILES;166810967;125673322;41137645;16029167;16302717;8805761;9891306;0;499629;0;590013;1129418;-539405;
